name,female,male,total,p_female,simulation
Ahia,26,17,43,0.6046511627906976,1
Alapaʻi,32,20,52,0.6153846153846154,1
Haʻaheo,18,19,37,0.4864864864864865,1
Hana,54,41,95,0.5684210526315789,1
Haole,30,16,46,0.6521739130434783,1
Hina,30,15,45,0.6666666666666666,1
ʻEhu,30,17,47,0.6382978723404256,1
Kahananui,58,37,95,0.6105263157894737,1
Kaheana,50,31,81,0.6172839506172839,1
Kahele,85,48,133,0.6390977443609023,1
Kahili/Kāhili,23,19,42,0.5476190476190477,1
Kahinu,30,23,53,0.5660377358490566,1
Kahue,82,65,147,0.5578231292517006,1
Kahuhu,25,15,40,0.625,1
Kaʻaeʻa,28,14,42,0.6666666666666666,1
Kaʻahanui,32,23,55,0.5818181818181818,1
Kaʻai,32,30,62,0.5161290322580645,1
Kaʻaihue,33,28,61,0.5409836065573771,1
Kaʻākau,40,29,69,0.5797101449275363,1
Kaʻanāʻanā,82,59,141,0.5815602836879432,1
Kaʻaua/Kaʻauʻa,58,40,98,0.5918367346938775,1
Kaʻaukai,48,22,70,0.6857142857142857,1
Kaʻawa,29,24,53,0.5471698113207547,1
Kaʻili,60,34,94,0.6382978723404256,1
Kaʻilianu,30,21,51,0.5882352941176471,1
Kaiʻa,47,30,77,0.6103896103896104,1
Kaina,29,18,47,0.6170212765957447,1
Kaipo,18,24,42,0.42857142857142855,1
Kaiwi,46,51,97,0.4742268041237113,1
Kalā/Kala,21,28,49,0.42857142857142855,1
Kalama,72,56,128,0.5625,1
Kalawaiʻa,64,35,99,0.6464646464646465,1
Kalehua,25,17,42,0.5952380952380952,1
Kalei,21,19,40,0.525,1
Kaleo,24,19,43,0.5581395348837209,1
Kalili,45,31,76,0.5921052631578947,1
Kalua,177,150,327,0.5412844036697247,1
Ahia,24,19,43,0.5581395348837209,2
Alapaʻi,31,21,52,0.5961538461538461,2
Haʻaheo,22,15,37,0.5945945945945946,2
Hana,49,46,95,0.5157894736842106,2
Haole,27,19,46,0.5869565217391305,2
Hina,29,16,45,0.6444444444444445,2
ʻEhu,27,20,47,0.574468085106383,2
Kahananui,56,39,95,0.5894736842105263,2
Kaheana,48,33,81,0.5925925925925926,2
Kahele,76,57,133,0.5714285714285714,2
Kahili/Kāhili,23,19,42,0.5476190476190477,2
Kahinu,37,16,53,0.6981132075471698,2
Kahue,89,58,147,0.6054421768707483,2
Kahuhu,21,19,40,0.525,2
Kaʻaeʻa,29,13,42,0.6904761904761905,2
Kaʻahanui,35,20,55,0.6363636363636364,2
Kaʻai,34,28,62,0.5483870967741935,2
Kaʻaihue,33,28,61,0.5409836065573771,2
Kaʻākau,38,31,69,0.5507246376811594,2
Kaʻanāʻanā,84,57,141,0.5957446808510638,2
Kaʻaua/Kaʻauʻa,67,31,98,0.6836734693877551,2
Kaʻaukai,35,35,70,0.5,2
Kaʻawa,29,24,53,0.5471698113207547,2
Kaʻili,53,41,94,0.5638297872340425,2
Kaʻilianu,28,23,51,0.5490196078431373,2
Kaiʻa,46,31,77,0.5974025974025974,2
Kaina,30,17,47,0.6382978723404256,2
Kaipo,22,20,42,0.5238095238095238,2
Kaiwi,54,43,97,0.5567010309278351,2
Kalā/Kala,29,20,49,0.5918367346938775,2
Kalama,67,61,128,0.5234375,2
Kalawaiʻa,53,46,99,0.5353535353535354,2
Kalehua,25,17,42,0.5952380952380952,2
Kalei,19,21,40,0.475,2
Kaleo,18,25,43,0.4186046511627907,2
Kalili,42,34,76,0.5526315789473685,2
Kalua,205,122,327,0.6269113149847095,2
Ahia,25,18,43,0.5813953488372093,3
Alapaʻi,36,16,52,0.6923076923076923,3
Haʻaheo,21,16,37,0.5675675675675675,3
Hana,57,38,95,0.6,3
Haole,27,19,46,0.5869565217391305,3
Hina,22,23,45,0.4888888888888889,3
ʻEhu,26,21,47,0.5531914893617021,3
Kahananui,61,34,95,0.6421052631578947,3
Kaheana,46,35,81,0.5679012345679012,3
Kahele,71,62,133,0.5338345864661654,3
Kahili/Kāhili,24,18,42,0.5714285714285714,3
Kahinu,37,16,53,0.6981132075471698,3
Kahue,90,57,147,0.6122448979591837,3
Kahuhu,24,16,40,0.6,3
Kaʻaeʻa,25,17,42,0.5952380952380952,3
Kaʻahanui,25,30,55,0.45454545454545453,3
Kaʻai,34,28,62,0.5483870967741935,3
Kaʻaihue,33,28,61,0.5409836065573771,3
Kaʻākau,42,27,69,0.6086956521739131,3
Kaʻanāʻanā,88,53,141,0.624113475177305,3
Kaʻaua/Kaʻauʻa,52,46,98,0.5306122448979592,3
Kaʻaukai,47,23,70,0.6714285714285714,3
Kaʻawa,33,20,53,0.6226415094339622,3
Kaʻili,56,38,94,0.5957446808510638,3
Kaʻilianu,27,24,51,0.5294117647058824,3
Kaiʻa,43,34,77,0.5584415584415584,3
Kaina,25,22,47,0.5319148936170213,3
Kaipo,27,15,42,0.6428571428571429,3
Kaiwi,61,36,97,0.6288659793814433,3
Kalā/Kala,31,18,49,0.6326530612244898,3
Kalama,70,58,128,0.546875,3
Kalawaiʻa,59,40,99,0.5959595959595959,3
Kalehua,25,17,42,0.5952380952380952,3
Kalei,24,16,40,0.6,3
Kaleo,25,18,43,0.5813953488372093,3
Kalili,32,44,76,0.42105263157894735,3
Kalua,183,144,327,0.5596330275229358,3
Ahia,19,24,43,0.4418604651162791,4
Alapaʻi,36,16,52,0.6923076923076923,4
Haʻaheo,25,12,37,0.6756756756756757,4
Hana,62,33,95,0.6526315789473685,4
Haole,30,16,46,0.6521739130434783,4
Hina,26,19,45,0.5777777777777777,4
ʻEhu,27,20,47,0.574468085106383,4
Kahananui,60,35,95,0.631578947368421,4
Kaheana,47,34,81,0.5802469135802469,4
Kahele,76,57,133,0.5714285714285714,4
Kahili/Kāhili,23,19,42,0.5476190476190477,4
Kahinu,28,25,53,0.5283018867924528,4
Kahue,78,69,147,0.5306122448979592,4
Kahuhu,20,20,40,0.5,4
Kaʻaeʻa,29,13,42,0.6904761904761905,4
Kaʻahanui,35,20,55,0.6363636363636364,4
Kaʻai,37,25,62,0.5967741935483871,4
Kaʻaihue,33,28,61,0.5409836065573771,4
Kaʻākau,40,29,69,0.5797101449275363,4
Kaʻanāʻanā,83,58,141,0.5886524822695035,4
Kaʻaua/Kaʻauʻa,60,38,98,0.6122448979591837,4
Kaʻaukai,39,31,70,0.5571428571428572,4
Kaʻawa,31,22,53,0.5849056603773585,4
Kaʻili,55,39,94,0.5851063829787234,4
Kaʻilianu,33,18,51,0.6470588235294118,4
Kaiʻa,49,28,77,0.6363636363636364,4
Kaina,26,21,47,0.5531914893617021,4
Kaipo,22,20,42,0.5238095238095238,4
Kaiwi,53,44,97,0.5463917525773195,4
Kalā/Kala,30,19,49,0.6122448979591837,4
Kalama,78,50,128,0.609375,4
Kalawaiʻa,59,40,99,0.5959595959595959,4
Kalehua,20,22,42,0.47619047619047616,4
Kalei,21,19,40,0.525,4
Kaleo,22,21,43,0.5116279069767442,4
Kalili,42,34,76,0.5526315789473685,4
Kalua,180,147,327,0.5504587155963303,4
Ahia,24,19,43,0.5581395348837209,5
Alapaʻi,32,20,52,0.6153846153846154,5
Haʻaheo,20,17,37,0.5405405405405406,5
Hana,59,36,95,0.6210526315789474,5
Haole,28,18,46,0.6086956521739131,5
Hina,31,14,45,0.6888888888888889,5
ʻEhu,28,19,47,0.5957446808510638,5
Kahananui,61,34,95,0.6421052631578947,5
Kaheana,48,33,81,0.5925925925925926,5
Kahele,76,57,133,0.5714285714285714,5
Kahili/Kāhili,27,15,42,0.6428571428571429,5
Kahinu,36,17,53,0.6792452830188679,5
Kahue,91,56,147,0.6190476190476191,5
Kahuhu,22,18,40,0.55,5
Kaʻaeʻa,24,18,42,0.5714285714285714,5
Kaʻahanui,35,20,55,0.6363636363636364,5
Kaʻai,39,23,62,0.6290322580645161,5
Kaʻaihue,40,21,61,0.6557377049180327,5
Kaʻākau,33,36,69,0.4782608695652174,5
Kaʻanāʻanā,82,59,141,0.5815602836879432,5
Kaʻaua/Kaʻauʻa,47,51,98,0.47959183673469385,5
Kaʻaukai,38,32,70,0.5428571428571428,5
Kaʻawa,38,15,53,0.71698113207547165,5
Kaʻili,55,39,94,0.5851063829787234,5
Kaʻilianu,30,21,51,0.5882352941176471,5
Kaiʻa,46,31,77,0.5974025974025974,5
Kaina,23,24,47,0.48936170212765956,5
Kaipo,24,18,42,0.5714285714285714,5
Kaiwi,53,44,97,0.5463917525773195,5
Kalā/Kala,25,24,49,0.5102040816326531,5
Kalama,68,60,128,0.53125,5
Kalawaiʻa,56,43,99,0.5656565656565656,5
Kalehua,23,19,42,0.5476190476190477,5
Kalei,24,16,40,0.6,5
Kaleo,28,15,43,0.6511627906976745,5
Kalili,45,31,76,0.5921052631578947,5
Kalua,175,152,327,0.5351681957186545,5
Ahia,25,18,43,0.5813953488372093,6
Alapaʻi,29,23,52,0.5576923076923077,6
Haʻaheo,26,11,37,0.7027027027027027,6
Hana,59,36,95,0.6210526315789474,6
Haole,22,24,46,0.4782608695652174,6
Hina,26,19,45,0.5777777777777777,6
ʻEhu,27,20,47,0.574468085106383,6
Kahananui,52,43,95,0.5473684210526316,6
Kaheana,46,35,81,0.5679012345679012,6
Kahele,68,65,133,0.5112781954887218,6
Kahili/Kāhili,20,22,42,0.47619047619047616,6
Kahinu,32,21,53,0.6037735849056604,6
Kahue,93,54,147,0.6326530612244898,6
Kahuhu,24,16,40,0.6,6
Kaʻaeʻa,24,18,42,0.5714285714285714,6
Kaʻahanui,33,22,55,0.6,6
Kaʻai,34,28,62,0.5483870967741935,6
Kaʻaihue,34,27,61,0.5573770491803278,6
Kaʻākau,48,21,69,0.6956521739130435,6
Kaʻanāʻanā,78,63,141,0.5531914893617021,6
Kaʻaua/Kaʻauʻa,61,37,98,0.6224489795918368,6
Kaʻaukai,33,37,70,0.4714285714285714,6
Kaʻawa,28,25,53,0.5283018867924528,6
Kaʻili,57,37,94,0.6063829787234043,6
Kaʻilianu,34,17,51,0.6666666666666666,6
Kaiʻa,47,30,77,0.6103896103896104,6
Kaina,30,17,47,0.6382978723404256,6
Kaipo,23,19,42,0.5476190476190477,6
Kaiwi,54,43,97,0.5567010309278351,6
Kalā/Kala,29,20,49,0.5918367346938775,6
Kalama,76,52,128,0.59375,6
Kalawaiʻa,64,35,99,0.6464646464646465,6
Kalehua,23,19,42,0.5476190476190477,6
Kalei,24,16,40,0.6,6
Kaleo,24,19,43,0.5581395348837209,6
Kalili,47,29,76,0.618421052631579,6
Kalua,180,147,327,0.5504587155963303,6
Ahia,25,18,43,0.5813953488372093,7
Alapaʻi,29,23,52,0.5576923076923077,7
Haʻaheo,17,20,37,0.4594594594594595,7
Hana,47,48,95,0.49473684210526314,7
Haole,24,22,46,0.5217391304347826,7
Hina,30,15,45,0.6666666666666666,7
ʻEhu,27,20,47,0.574468085106383,7
Kahananui,55,40,95,0.5789473684210527,7
Kaheana,48,33,81,0.5925925925925926,7
Kahele,74,59,133,0.556390977443609,7
Kahili/Kāhili,29,13,42,0.6904761904761905,7
Kahinu,34,19,53,0.6415094339622641,7
Kahue,88,59,147,0.5986394557823129,7
Kahuhu,23,17,40,0.575,7
Kaʻaeʻa,23,19,42,0.5476190476190477,7
Kaʻahanui,42,13,55,0.7636363636363637,7
Kaʻai,34,28,62,0.5483870967741935,7
Kaʻaihue,41,20,61,0.6721311475409836,7
Kaʻākau,44,25,69,0.6376811594202898,7
Kaʻanāʻanā,84,57,141,0.5957446808510638,7
Kaʻaua/Kaʻauʻa,55,43,98,0.5612244897959183,7
Kaʻaukai,42,28,70,0.6,7
Kaʻawa,32,21,53,0.6037735849056604,7
Kaʻili,58,36,94,0.6170212765957447,7
Kaʻilianu,35,16,51,0.6862745098039216,7
Kaiʻa,39,38,77,0.5064935064935064,7
Kaina,25,22,47,0.5319148936170213,7
Kaipo,32,10,42,0.7619047619047619,7
Kaiwi,58,39,97,0.5979381443298969,7
Kalā/Kala,28,21,49,0.5714285714285714,7
Kalama,69,59,128,0.5390625,7
Kalawaiʻa,44,55,99,0.4444444444444444,7
Kalehua,29,13,42,0.6904761904761905,7
Kalei,25,15,40,0.625,7
Kaleo,25,18,43,0.5813953488372093,7
Kalili,44,32,76,0.5789473684210527,7
Kalua,176,151,327,0.5382262996941896,7
Ahia,23,20,43,0.5348837209302325,8
Alapaʻi,36,16,52,0.6923076923076923,8
Haʻaheo,21,16,37,0.5675675675675675,8
Hana,44,51,95,0.4631578947368421,8
Haole,29,17,46,0.6304347826086957,8
Hina,26,19,45,0.5777777777777777,8
ʻEhu,33,14,47,0.7021276595744681,8
Kahananui,55,40,95,0.5789473684210527,8
Kaheana,42,39,81,0.5185185185185185,8
Kahele,71,62,133,0.5338345864661654,8
Kahili/Kāhili,25,17,42,0.5952380952380952,8
Kahinu,28,25,53,0.5283018867924528,8
Kahue,88,59,147,0.5986394557823129,8
Kahuhu,21,19,40,0.525,8
Kaʻaeʻa,29,13,42,0.6904761904761905,8
Kaʻahanui,36,19,55,0.6545454545454545,8
Kaʻai,36,26,62,0.5806451612903226,8
Kaʻaihue,32,29,61,0.5245901639344263,8
Kaʻākau,44,25,69,0.6376811594202898,8
Kaʻanāʻanā,72,69,141,0.5106382978723404,8
Kaʻaua/Kaʻauʻa,61,37,98,0.6224489795918368,8
Kaʻaukai,38,32,70,0.5428571428571428,8
Kaʻawa,33,20,53,0.6226415094339622,8
Kaʻili,56,38,94,0.5957446808510638,8
Kaʻilianu,26,25,51,0.5098039215686274,8
Kaiʻa,48,29,77,0.6233766233766234,8
Kaina,32,15,47,0.6808510638297872,8
Kaipo,26,16,42,0.6190476190476191,8
Kaiwi,55,42,97,0.5670103092783505,8
Kalā/Kala,28,21,49,0.5714285714285714,8
Kalama,83,45,128,0.6484375,8
Kalawaiʻa,56,43,99,0.5656565656565656,8
Kalehua,16,26,42,0.38095238095238093,8
Kalei,24,16,40,0.6,8
Kaleo,30,13,43,0.6976744186046512,8
Kalili,46,30,76,0.6052631578947368,8
Kalua,185,142,327,0.5657492354740061,8
Ahia,25,18,43,0.5813953488372093,9
Alapaʻi,30,22,52,0.5769230769230769,9
Haʻaheo,26,11,37,0.7027027027027027,9
Hana,57,38,95,0.6,9
Haole,25,21,46,0.5434782608695652,9
Hina,27,18,45,0.6,9
ʻEhu,28,19,47,0.5957446808510638,9
Kahananui,55,40,95,0.5789473684210527,9
Kaheana,51,30,81,0.6296296296296297,9
Kahele,76,57,133,0.5714285714285714,9
Kahili/Kāhili,21,21,42,0.5,9
Kahinu,35,18,53,0.660377358490566,9
Kahue,82,65,147,0.5578231292517006,9
Kahuhu,25,15,40,0.625,9
Kaʻaeʻa,22,20,42,0.5238095238095238,9
Kaʻahanui,26,29,55,0.4727272727272727,9
Kaʻai,33,29,62,0.532258064516129,9
Kaʻaihue,30,31,61,0.4918032786885246,9
Kaʻākau,43,26,69,0.6231884057971014,9
Kaʻanāʻanā,91,50,141,0.6453900709219859,9
Kaʻaua/Kaʻauʻa,57,41,98,0.5816326530612245,9
Kaʻaukai,38,32,70,0.5428571428571428,9
Kaʻawa,34,19,53,0.6415094339622641,9
Kaʻili,60,34,94,0.6382978723404256,9
Kaʻilianu,29,22,51,0.5686274509803921,9
Kaiʻa,34,43,77,0.44155844155844154,9
Kaina,31,16,47,0.6595744680851063,9
Kaipo,24,18,42,0.5714285714285714,9
Kaiwi,53,44,97,0.5463917525773195,9
Kalā/Kala,32,17,49,0.6530612244897959,9
Kalama,81,47,128,0.6328125,9
Kalawaiʻa,54,45,99,0.5454545454545454,9
Kalehua,25,17,42,0.5952380952380952,9
Kalei,17,23,40,0.425,9
Kaleo,25,18,43,0.5813953488372093,9
Kalili,45,31,76,0.5921052631578947,9
Kalua,187,140,327,0.5718654434250765,9
Ahia,23,20,43,0.5348837209302325,10
Alapaʻi,34,18,52,0.6538461538461539,10
Haʻaheo,21,16,37,0.5675675675675675,10
Hana,53,42,95,0.5578947368421052,10
Haole,31,15,46,0.6739130434782609,10
Hina,22,23,45,0.4888888888888889,10
ʻEhu,28,19,47,0.5957446808510638,10
Kahananui,58,37,95,0.6105263157894737,10
Kaheana,47,34,81,0.5802469135802469,10
Kahele,74,59,133,0.556390977443609,10
Kahili/Kāhili,25,17,42,0.5952380952380952,10
Kahinu,33,20,53,0.6226415094339622,10
Kahue,82,65,147,0.5578231292517006,10
Kahuhu,25,15,40,0.625,10
Kaʻaeʻa,27,15,42,0.6428571428571429,10
Kaʻahanui,32,23,55,0.5818181818181818,10
Kaʻai,39,23,62,0.6290322580645161,10
Kaʻaihue,34,27,61,0.5573770491803278,10
Kaʻākau,32,37,69,0.463768115942029,10
Kaʻanāʻanā,81,60,141,0.574468085106383,10
Kaʻaua/Kaʻauʻa,48,50,98,0.4897959183673469,10
Kaʻaukai,41,29,70,0.5857142857142857,10
Kaʻawa,41,12,53,0.7735849056603774,10
Kaʻili,52,42,94,0.5531914893617021,10
Kaʻilianu,27,24,51,0.5294117647058824,10
Kaiʻa,41,36,77,0.5324675324675324,10
Kaina,20,27,47,0.425531914893617,10
Kaipo,28,14,42,0.6666666666666666,10
Kaiwi,61,36,97,0.6288659793814433,10
Kalā/Kala,23,26,49,0.46938775510204084,10
Kalama,77,51,128,0.6015625,10
Kalawaiʻa,72,27,99,0.7272727272727273,10
Kalehua,24,18,42,0.5714285714285714,10
Kalei,21,19,40,0.525,10
Kaleo,21,22,43,0.4883720930232558,10
Kalili,43,33,76,0.5657894736842105,10
Kalua,193,134,327,0.5902140672782875,10
Ahia,26,17,43,0.6046511627906976,11
Alapaʻi,34,18,52,0.6538461538461539,11
Haʻaheo,26,11,37,0.7027027027027027,11
Hana,49,46,95,0.5157894736842106,11
Haole,28,18,46,0.6086956521739131,11
Hina,28,17,45,0.6222222222222222,11
ʻEhu,28,19,47,0.5957446808510638,11
Kahananui,59,36,95,0.6210526315789474,11
Kaheana,47,34,81,0.5802469135802469,11
Kahele,74,59,133,0.556390977443609,11
Kahili/Kāhili,31,11,42,0.7380952380952381,11
Kahinu,38,15,53,0.71698113207547165,11
Kahue,81,66,147,0.5510204081632653,11
Kahuhu,27,13,40,0.675,11
Kaʻaeʻa,23,19,42,0.5476190476190477,11
Kaʻahanui,29,26,55,0.5272727272727272,11
Kaʻai,41,21,62,0.6612903225806451,11
Kaʻaihue,24,37,61,0.39344262295081966,11
Kaʻākau,40,29,69,0.5797101449275363,11
Kaʻanāʻanā,87,54,141,0.6170212765957447,11
Kaʻaua/Kaʻauʻa,56,42,98,0.5714285714285714,11
Kaʻaukai,37,33,70,0.5285714285714286,11
Kaʻawa,34,19,53,0.6415094339622641,11
Kaʻili,61,33,94,0.648936170212766,11
Kaʻilianu,27,24,51,0.5294117647058824,11
Kaiʻa,45,32,77,0.5844155844155844,11
Kaina,27,20,47,0.574468085106383,11
Kaipo,27,15,42,0.6428571428571429,11
Kaiwi,49,48,97,0.5051546391752577,11
Kalā/Kala,27,22,49,0.5510204081632653,11
Kalama,77,51,128,0.6015625,11
Kalawaiʻa,48,51,99,0.48484848484848486,11
Kalehua,30,12,42,0.7142857142857143,11
Kalei,22,18,40,0.55,11
Kaleo,26,17,43,0.6046511627906976,11
Kalili,41,35,76,0.5394736842105263,11
Kalua,180,147,327,0.5504587155963303,11
Ahia,29,14,43,0.6744186046511628,12
Alapaʻi,27,25,52,0.5192307692307693,12
Haʻaheo,21,16,37,0.5675675675675675,12
Hana,57,38,95,0.6,12
Haole,28,18,46,0.6086956521739131,12
Hina,21,24,45,0.4666666666666667,12
ʻEhu,25,22,47,0.5319148936170213,12
Kahananui,56,39,95,0.5894736842105263,12
Kaheana,47,34,81,0.5802469135802469,12
Kahele,78,55,133,0.5864661654135338,12
Kahili/Kāhili,19,23,42,0.4523809523809524,12
Kahinu,33,20,53,0.6226415094339622,12
Kahue,92,55,147,0.6258503401360545,12
Kahuhu,23,17,40,0.575,12
Kaʻaeʻa,28,14,42,0.6666666666666666,12
Kaʻahanui,35,20,55,0.6363636363636364,12
Kaʻai,40,22,62,0.6451612903225806,12
Kaʻaihue,33,28,61,0.5409836065573771,12
Kaʻākau,40,29,69,0.5797101449275363,12
Kaʻanāʻanā,70,71,141,0.49645390070921985,12
Kaʻaua/Kaʻauʻa,47,51,98,0.47959183673469385,12
Kaʻaukai,43,27,70,0.6142857142857143,12
Kaʻawa,31,22,53,0.5849056603773585,12
Kaʻili,61,33,94,0.648936170212766,12
Kaʻilianu,35,16,51,0.6862745098039216,12
Kaiʻa,45,32,77,0.5844155844155844,12
Kaina,30,17,47,0.6382978723404256,12
Kaipo,22,20,42,0.5238095238095238,12
Kaiwi,50,47,97,0.5154639175257731,12
Kalā/Kala,25,24,49,0.5102040816326531,12
Kalama,73,55,128,0.5703125,12
Kalawaiʻa,58,41,99,0.5858585858585859,12
Kalehua,27,15,42,0.6428571428571429,12
Kalei,30,10,40,0.75,12
Kaleo,25,18,43,0.5813953488372093,12
Kalili,48,28,76,0.631578947368421,12
Kalua,182,145,327,0.5565749235474006,12
Ahia,25,18,43,0.5813953488372093,13
Alapaʻi,32,20,52,0.6153846153846154,13
Haʻaheo,15,22,37,0.40540540540540543,13
Hana,57,38,95,0.6,13
Haole,29,17,46,0.6304347826086957,13
Hina,24,21,45,0.5333333333333333,13
ʻEhu,33,14,47,0.7021276595744681,13
Kahananui,58,37,95,0.6105263157894737,13
Kaheana,41,40,81,0.5061728395061729,13
Kahele,77,56,133,0.5789473684210527,13
Kahili/Kāhili,24,18,42,0.5714285714285714,13
Kahinu,28,25,53,0.5283018867924528,13
Kahue,84,63,147,0.5714285714285714,13
Kahuhu,20,20,40,0.5,13
Kaʻaeʻa,16,26,42,0.38095238095238093,13
Kaʻahanui,36,19,55,0.6545454545454545,13
Kaʻai,32,30,62,0.5161290322580645,13
Kaʻaihue,39,22,61,0.639344262295082,13
Kaʻākau,35,34,69,0.5072463768115942,13
Kaʻanāʻanā,84,57,141,0.5957446808510638,13
Kaʻaua/Kaʻauʻa,61,37,98,0.6224489795918368,13
Kaʻaukai,39,31,70,0.5571428571428572,13
Kaʻawa,26,27,53,0.49056603773584906,13
Kaʻili,52,42,94,0.5531914893617021,13
Kaʻilianu,38,13,51,0.7450980392156863,13
Kaiʻa,47,30,77,0.6103896103896104,13
Kaina,24,23,47,0.5106382978723404,13
Kaipo,23,19,42,0.5476190476190477,13
Kaiwi,55,42,97,0.5670103092783505,13
Kalā/Kala,30,19,49,0.6122448979591837,13
Kalama,77,51,128,0.6015625,13
Kalawaiʻa,66,33,99,0.6666666666666666,13
Kalehua,24,18,42,0.5714285714285714,13
Kalei,26,14,40,0.65,13
Kaleo,24,19,43,0.5581395348837209,13
Kalili,41,35,76,0.5394736842105263,13
Kalua,192,135,327,0.5871559633027523,13
Ahia,18,25,43,0.4186046511627907,14
Alapaʻi,33,19,52,0.6346153846153846,14
Haʻaheo,18,19,37,0.4864864864864865,14
Hana,62,33,95,0.6526315789473685,14
Haole,22,24,46,0.4782608695652174,14
Hina,27,18,45,0.6,14
ʻEhu,19,28,47,0.40425531914893614,14
Kahananui,56,39,95,0.5894736842105263,14
Kaheana,46,35,81,0.5679012345679012,14
Kahele,76,57,133,0.5714285714285714,14
Kahili/Kāhili,24,18,42,0.5714285714285714,14
Kahinu,36,17,53,0.6792452830188679,14
Kahue,87,60,147,0.5918367346938775,14
Kahuhu,22,18,40,0.55,14
Kaʻaeʻa,28,14,42,0.6666666666666666,14
Kaʻahanui,28,27,55,0.509090909090909,14
Kaʻai,40,22,62,0.6451612903225806,14
Kaʻaihue,31,30,61,0.5081967213114754,14
Kaʻākau,40,29,69,0.5797101449275363,14
Kaʻanāʻanā,77,64,141,0.5460992907801419,14
Kaʻaua/Kaʻauʻa,56,42,98,0.5714285714285714,14
Kaʻaukai,41,29,70,0.5857142857142857,14
Kaʻawa,27,26,53,0.5094339622641509,14
Kaʻili,49,45,94,0.5212765957446809,14
Kaʻilianu,32,19,51,0.6274509803921569,14
Kaiʻa,50,27,77,0.6493506493506493,14
Kaina,29,18,47,0.6170212765957447,14
Kaipo,24,18,42,0.5714285714285714,14
Kaiwi,57,40,97,0.5876288659793815,14
Kalā/Kala,35,14,49,0.7142857142857143,14
Kalama,80,48,128,0.625,14
Kalawaiʻa,54,45,99,0.5454545454545454,14
Kalehua,25,17,42,0.5952380952380952,14
Kalei,22,18,40,0.55,14
Kaleo,26,17,43,0.6046511627906976,14
Kalili,50,26,76,0.6578947368421053,14
Kalua,187,140,327,0.5718654434250765,14
Ahia,20,23,43,0.46511627906976744,15
Alapaʻi,32,20,52,0.6153846153846154,15
Haʻaheo,23,14,37,0.6216216216216216,15
Hana,50,45,95,0.5263157894736842,15
Haole,31,15,46,0.6739130434782609,15
Hina,26,19,45,0.5777777777777777,15
ʻEhu,32,15,47,0.6808510638297872,15
Kahananui,48,47,95,0.5052631578947369,15
Kaheana,52,29,81,0.6419753086419753,15
Kahele,81,52,133,0.6090225563909775,15
Kahili/Kāhili,26,16,42,0.6190476190476191,15
Kahinu,29,24,53,0.5471698113207547,15
Kahue,85,62,147,0.5782312925170068,15
Kahuhu,22,18,40,0.55,15
Kaʻaeʻa,25,17,42,0.5952380952380952,15
Kaʻahanui,31,24,55,0.5636363636363636,15
Kaʻai,39,23,62,0.6290322580645161,15
Kaʻaihue,39,22,61,0.639344262295082,15
Kaʻākau,39,30,69,0.5652173913043478,15
Kaʻanāʻanā,77,64,141,0.5460992907801419,15
Kaʻaua/Kaʻauʻa,60,38,98,0.6122448979591837,15
Kaʻaukai,36,34,70,0.5142857142857142,15
Kaʻawa,29,24,53,0.5471698113207547,15
Kaʻili,52,42,94,0.5531914893617021,15
Kaʻilianu,31,20,51,0.6078431372549019,15
Kaiʻa,47,30,77,0.6103896103896104,15
Kaina,21,26,47,0.44680851063829785,15
Kaipo,26,16,42,0.6190476190476191,15
Kaiwi,57,40,97,0.5876288659793815,15
Kalā/Kala,29,20,49,0.5918367346938775,15
Kalama,73,55,128,0.5703125,15
Kalawaiʻa,58,41,99,0.5858585858585859,15
Kalehua,23,19,42,0.5476190476190477,15
Kalei,28,12,40,0.7,15
Kaleo,24,19,43,0.5581395348837209,15
Kalili,43,33,76,0.5657894736842105,15
Kalua,190,137,327,0.581039755351682,15
Ahia,28,15,43,0.6511627906976745,16
Alapaʻi,27,25,52,0.5192307692307693,16
Haʻaheo,23,14,37,0.6216216216216216,16
Hana,49,46,95,0.5157894736842106,16
Haole,31,15,46,0.6739130434782609,16
Hina,26,19,45,0.5777777777777777,16
ʻEhu,29,18,47,0.6170212765957447,16
Kahananui,58,37,95,0.6105263157894737,16
Kaheana,43,38,81,0.5308641975308642,16
Kahele,70,63,133,0.5263157894736842,16
Kahili/Kāhili,23,19,42,0.5476190476190477,16
Kahinu,30,23,53,0.5660377358490566,16
Kahue,81,66,147,0.5510204081632653,16
Kahuhu,26,14,40,0.65,16
Kaʻaeʻa,18,24,42,0.42857142857142855,16
Kaʻahanui,35,20,55,0.6363636363636364,16
Kaʻai,37,25,62,0.5967741935483871,16
Kaʻaihue,34,27,61,0.5573770491803278,16
Kaʻākau,40,29,69,0.5797101449275363,16
Kaʻanāʻanā,86,55,141,0.6099290780141844,16
Kaʻaua/Kaʻauʻa,57,41,98,0.5816326530612245,16
Kaʻaukai,39,31,70,0.5571428571428572,16
Kaʻawa,35,18,53,0.660377358490566,16
Kaʻili,60,34,94,0.6382978723404256,16
Kaʻilianu,30,21,51,0.5882352941176471,16
Kaiʻa,40,37,77,0.5194805194805194,16
Kaina,24,23,47,0.5106382978723404,16
Kaipo,27,15,42,0.6428571428571429,16
Kaiwi,57,40,97,0.5876288659793815,16
Kalā/Kala,29,20,49,0.5918367346938775,16
Kalama,87,41,128,0.6796875,16
Kalawaiʻa,59,40,99,0.5959595959595959,16
Kalehua,20,22,42,0.47619047619047616,16
Kalei,25,15,40,0.625,16
Kaleo,27,16,43,0.627906976744186,16
Kalili,38,38,76,0.5,16
Kalua,186,141,327,0.5688073394495413,16
Ahia,23,20,43,0.5348837209302325,17
Alapaʻi,33,19,52,0.6346153846153846,17
Haʻaheo,17,20,37,0.4594594594594595,17
Hana,56,39,95,0.5894736842105263,17
Haole,29,17,46,0.6304347826086957,17
Hina,29,16,45,0.6444444444444445,17
ʻEhu,26,21,47,0.5531914893617021,17
Kahananui,54,41,95,0.5684210526315789,17
Kaheana,39,42,81,0.48148148148148145,17
Kahele,75,58,133,0.5639097744360902,17
Kahili/Kāhili,27,15,42,0.6428571428571429,17
Kahinu,37,16,53,0.6981132075471698,17
Kahue,88,59,147,0.5986394557823129,17
Kahuhu,20,20,40,0.5,17
Kaʻaeʻa,27,15,42,0.6428571428571429,17
Kaʻahanui,33,22,55,0.6,17
Kaʻai,30,32,62,0.4838709677419355,17
Kaʻaihue,29,32,61,0.47540983606557374,17
Kaʻākau,38,31,69,0.5507246376811594,17
Kaʻanāʻanā,82,59,141,0.5815602836879432,17
Kaʻaua/Kaʻauʻa,50,48,98,0.5102040816326531,17
Kaʻaukai,39,31,70,0.5571428571428572,17
Kaʻawa,33,20,53,0.6226415094339622,17
Kaʻili,55,39,94,0.5851063829787234,17
Kaʻilianu,31,20,51,0.6078431372549019,17
Kaiʻa,45,32,77,0.5844155844155844,17
Kaina,33,14,47,0.7021276595744681,17
Kaipo,22,20,42,0.5238095238095238,17
Kaiwi,53,44,97,0.5463917525773195,17
Kalā/Kala,22,27,49,0.4489795918367347,17
Kalama,81,47,128,0.6328125,17
Kalawaiʻa,63,36,99,0.6363636363636364,17
Kalehua,32,10,42,0.7619047619047619,17
Kalei,16,24,40,0.4,17
Kaleo,24,19,43,0.5581395348837209,17
Kalili,51,25,76,0.6710526315789473,17
Kalua,192,135,327,0.5871559633027523,17
Ahia,23,20,43,0.5348837209302325,18
Alapaʻi,25,27,52,0.4807692307692308,18
Haʻaheo,26,11,37,0.7027027027027027,18
Hana,47,48,95,0.49473684210526314,18
Haole,25,21,46,0.5434782608695652,18
Hina,31,14,45,0.6888888888888889,18
ʻEhu,31,16,47,0.6595744680851063,18
Kahananui,52,43,95,0.5473684210526316,18
Kaheana,48,33,81,0.5925925925925926,18
Kahele,76,57,133,0.5714285714285714,18
Kahili/Kāhili,22,20,42,0.5238095238095238,18
Kahinu,31,22,53,0.5849056603773585,18
Kahue,87,60,147,0.5918367346938775,18
Kahuhu,26,14,40,0.65,18
Kaʻaeʻa,22,20,42,0.5238095238095238,18
Kaʻahanui,37,18,55,0.6727272727272727,18
Kaʻai,35,27,62,0.5645161290322581,18
Kaʻaihue,35,26,61,0.5737704918032787,18
Kaʻākau,42,27,69,0.6086956521739131,18
Kaʻanāʻanā,81,60,141,0.574468085106383,18
Kaʻaua/Kaʻauʻa,51,47,98,0.5204081632653061,18
Kaʻaukai,38,32,70,0.5428571428571428,18
Kaʻawa,31,22,53,0.5849056603773585,18
Kaʻili,53,41,94,0.5638297872340425,18
Kaʻilianu,31,20,51,0.6078431372549019,18
Kaiʻa,48,29,77,0.6233766233766234,18
Kaina,27,20,47,0.574468085106383,18
Kaipo,25,17,42,0.5952380952380952,18
Kaiwi,53,44,97,0.5463917525773195,18
Kalā/Kala,23,26,49,0.46938775510204084,18
Kalama,74,54,128,0.578125,18
Kalawaiʻa,49,50,99,0.494949494949495,18
Kalehua,25,17,42,0.5952380952380952,18
Kalei,27,13,40,0.675,18
Kaleo,29,14,43,0.6744186046511628,18
Kalili,55,21,76,0.7236842105263158,18
Kalua,193,134,327,0.5902140672782875,18
Ahia,24,19,43,0.5581395348837209,19
Alapaʻi,26,26,52,0.5,19
Haʻaheo,19,18,37,0.5135135135135135,19
Hana,48,47,95,0.5052631578947369,19
Haole,22,24,46,0.4782608695652174,19
Hina,29,16,45,0.6444444444444445,19
ʻEhu,29,18,47,0.6170212765957447,19
Kahananui,58,37,95,0.6105263157894737,19
Kaheana,48,33,81,0.5925925925925926,19
Kahele,81,52,133,0.6090225563909775,19
Kahili/Kāhili,22,20,42,0.5238095238095238,19
Kahinu,35,18,53,0.660377358490566,19
Kahue,95,52,147,0.6462585034013606,19
Kahuhu,25,15,40,0.625,19
Kaʻaeʻa,25,17,42,0.5952380952380952,19
Kaʻahanui,25,30,55,0.45454545454545453,19
Kaʻai,37,25,62,0.5967741935483871,19
Kaʻaihue,39,22,61,0.639344262295082,19
Kaʻākau,39,30,69,0.5652173913043478,19
Kaʻanāʻanā,83,58,141,0.5886524822695035,19
Kaʻaua/Kaʻauʻa,51,47,98,0.5204081632653061,19
Kaʻaukai,45,25,70,0.6428571428571429,19
Kaʻawa,27,26,53,0.5094339622641509,19
Kaʻili,56,38,94,0.5957446808510638,19
Kaʻilianu,34,17,51,0.6666666666666666,19
Kaiʻa,52,25,77,0.6753246753246753,19
Kaina,26,21,47,0.5531914893617021,19
Kaipo,18,24,42,0.42857142857142855,19
Kaiwi,60,37,97,0.6185567010309279,19
Kalā/Kala,26,23,49,0.5306122448979592,19
Kalama,84,44,128,0.65625,19
Kalawaiʻa,54,45,99,0.5454545454545454,19
Kalehua,27,15,42,0.6428571428571429,19
Kalei,20,20,40,0.5,19
Kaleo,28,15,43,0.6511627906976745,19
Kalili,46,30,76,0.6052631578947368,19
Kalua,171,156,327,0.5229357798165137,19
Ahia,26,17,43,0.6046511627906976,20
Alapaʻi,30,22,52,0.5769230769230769,20
Haʻaheo,22,15,37,0.5945945945945946,20
Hana,66,29,95,0.6947368421052632,20
Haole,23,23,46,0.5,20
Hina,25,20,45,0.5555555555555556,20
ʻEhu,26,21,47,0.5531914893617021,20
Kahananui,57,38,95,0.6,20
Kaheana,44,37,81,0.5432098765432098,20
Kahele,71,62,133,0.5338345864661654,20
Kahili/Kāhili,23,19,42,0.5476190476190477,20
Kahinu,30,23,53,0.5660377358490566,20
Kahue,78,69,147,0.5306122448979592,20
Kahuhu,18,22,40,0.45,20
Kaʻaeʻa,23,19,42,0.5476190476190477,20
Kaʻahanui,32,23,55,0.5818181818181818,20
Kaʻai,36,26,62,0.5806451612903226,20
Kaʻaihue,34,27,61,0.5573770491803278,20
Kaʻākau,38,31,69,0.5507246376811594,20
Kaʻanāʻanā,79,62,141,0.5602836879432624,20
Kaʻaua/Kaʻauʻa,66,32,98,0.673469387755102,20
Kaʻaukai,39,31,70,0.5571428571428572,20
Kaʻawa,36,17,53,0.6792452830188679,20
Kaʻili,57,37,94,0.6063829787234043,20
Kaʻilianu,28,23,51,0.5490196078431373,20
Kaiʻa,44,33,77,0.5714285714285714,20
Kaina,30,17,47,0.6382978723404256,20
Kaipo,31,11,42,0.7380952380952381,20
Kaiwi,59,38,97,0.6082474226804123,20
Kalā/Kala,29,20,49,0.5918367346938775,20
Kalama,72,56,128,0.5625,20
Kalawaiʻa,56,43,99,0.5656565656565656,20
Kalehua,30,12,42,0.7142857142857143,20
Kalei,24,16,40,0.6,20
Kaleo,22,21,43,0.5116279069767442,20
Kalili,46,30,76,0.6052631578947368,20
Kalua,184,143,327,0.5626911314984709,20
Ahia,24,19,43,0.5581395348837209,21
Alapaʻi,27,25,52,0.5192307692307693,21
Haʻaheo,19,18,37,0.5135135135135135,21
Hana,48,47,95,0.5052631578947369,21
Haole,25,21,46,0.5434782608695652,21
Hina,31,14,45,0.6888888888888889,21
ʻEhu,30,17,47,0.6382978723404256,21
Kahananui,53,42,95,0.5578947368421052,21
Kaheana,46,35,81,0.5679012345679012,21
Kahele,69,64,133,0.518796992481203,21
Kahili/Kāhili,23,19,42,0.5476190476190477,21
Kahinu,35,18,53,0.660377358490566,21
Kahue,86,61,147,0.5850340136054422,21
Kahuhu,26,14,40,0.65,21
Kaʻaeʻa,21,21,42,0.5,21
Kaʻahanui,33,22,55,0.6,21
Kaʻai,43,19,62,0.6935483870967742,21
Kaʻaihue,42,19,61,0.6885245901639344,21
Kaʻākau,42,27,69,0.6086956521739131,21
Kaʻanāʻanā,85,56,141,0.6028368794326241,21
Kaʻaua/Kaʻauʻa,56,42,98,0.5714285714285714,21
Kaʻaukai,41,29,70,0.5857142857142857,21
Kaʻawa,26,27,53,0.49056603773584906,21
Kaʻili,55,39,94,0.5851063829787234,21
Kaʻilianu,31,20,51,0.6078431372549019,21
Kaiʻa,34,43,77,0.44155844155844154,21
Kaina,31,16,47,0.6595744680851063,21
Kaipo,27,15,42,0.6428571428571429,21
Kaiwi,56,41,97,0.5773195876288659,21
Kalā/Kala,33,16,49,0.673469387755102,21
Kalama,76,52,128,0.59375,21
Kalawaiʻa,66,33,99,0.6666666666666666,21
Kalehua,23,19,42,0.5476190476190477,21
Kalei,21,19,40,0.525,21
Kaleo,21,22,43,0.4883720930232558,21
Kalili,43,33,76,0.5657894736842105,21
Kalua,186,141,327,0.5688073394495413,21
Ahia,28,15,43,0.6511627906976745,22
Alapaʻi,25,27,52,0.4807692307692308,22
Haʻaheo,19,18,37,0.5135135135135135,22
Hana,64,31,95,0.6736842105263158,22
Haole,26,20,46,0.5652173913043478,22
Hina,32,13,45,0.7111111111111111,22
ʻEhu,26,21,47,0.5531914893617021,22
Kahananui,53,42,95,0.5578947368421052,22
Kaheana,41,40,81,0.5061728395061729,22
Kahele,76,57,133,0.5714285714285714,22
Kahili/Kāhili,22,20,42,0.5238095238095238,22
Kahinu,36,17,53,0.6792452830188679,22
Kahue,78,69,147,0.5306122448979592,22
Kahuhu,20,20,40,0.5,22
Kaʻaeʻa,23,19,42,0.5476190476190477,22
Kaʻahanui,37,18,55,0.6727272727272727,22
Kaʻai,34,28,62,0.5483870967741935,22
Kaʻaihue,36,25,61,0.5901639344262295,22
Kaʻākau,43,26,69,0.6231884057971014,22
Kaʻanāʻanā,93,48,141,0.6595744680851063,22
Kaʻaua/Kaʻauʻa,48,50,98,0.4897959183673469,22
Kaʻaukai,38,32,70,0.5428571428571428,22
Kaʻawa,30,23,53,0.5660377358490566,22
Kaʻili,53,41,94,0.5638297872340425,22
Kaʻilianu,35,16,51,0.6862745098039216,22
Kaiʻa,43,34,77,0.5584415584415584,22
Kaina,22,25,47,0.46808510638297873,22
Kaipo,22,20,42,0.5238095238095238,22
Kaiwi,56,41,97,0.5773195876288659,22
Kalā/Kala,37,12,49,0.7551020408163265,22
Kalama,74,54,128,0.578125,22
Kalawaiʻa,51,48,99,0.5151515151515151,22
Kalehua,24,18,42,0.5714285714285714,22
Kalei,26,14,40,0.65,22
Kaleo,33,10,43,0.7674418604651163,22
Kalili,48,28,76,0.631578947368421,22
Kalua,182,145,327,0.5565749235474006,22
Ahia,24,19,43,0.5581395348837209,23
Alapaʻi,30,22,52,0.5769230769230769,23
Haʻaheo,21,16,37,0.5675675675675675,23
Hana,54,41,95,0.5684210526315789,23
Haole,30,16,46,0.6521739130434783,23
Hina,29,16,45,0.6444444444444445,23
ʻEhu,31,16,47,0.6595744680851063,23
Kahananui,50,45,95,0.5263157894736842,23
Kaheana,50,31,81,0.6172839506172839,23
Kahele,84,49,133,0.631578947368421,23
Kahili/Kāhili,25,17,42,0.5952380952380952,23
Kahinu,24,29,53,0.4528301886792453,23
Kahue,89,58,147,0.6054421768707483,23
Kahuhu,28,12,40,0.7,23
Kaʻaeʻa,20,22,42,0.47619047619047616,23
Kaʻahanui,37,18,55,0.6727272727272727,23
Kaʻai,41,21,62,0.6612903225806451,23
Kaʻaihue,35,26,61,0.5737704918032787,23
Kaʻākau,39,30,69,0.5652173913043478,23
Kaʻanāʻanā,86,55,141,0.6099290780141844,23
Kaʻaua/Kaʻauʻa,54,44,98,0.5510204081632653,23
Kaʻaukai,40,30,70,0.5714285714285714,23
Kaʻawa,29,24,53,0.5471698113207547,23
Kaʻili,50,44,94,0.5319148936170213,23
Kaʻilianu,32,19,51,0.6274509803921569,23
Kaiʻa,42,35,77,0.5454545454545454,23
Kaina,27,20,47,0.574468085106383,23
Kaipo,23,19,42,0.5476190476190477,23
Kaiwi,55,42,97,0.5670103092783505,23
Kalā/Kala,36,13,49,0.7346938775510204,23
Kalama,69,59,128,0.5390625,23
Kalawaiʻa,50,49,99,0.5050505050505051,23
Kalehua,25,17,42,0.5952380952380952,23
Kalei,26,14,40,0.65,23
Kaleo,28,15,43,0.6511627906976745,23
Kalili,46,30,76,0.6052631578947368,23
Kalua,175,152,327,0.5351681957186545,23
Ahia,22,21,43,0.5116279069767442,24
Alapaʻi,32,20,52,0.6153846153846154,24
Haʻaheo,21,16,37,0.5675675675675675,24
Hana,58,37,95,0.6105263157894737,24
Haole,30,16,46,0.6521739130434783,24
Hina,21,24,45,0.4666666666666667,24
ʻEhu,30,17,47,0.6382978723404256,24
Kahananui,56,39,95,0.5894736842105263,24
Kaheana,49,32,81,0.6049382716049383,24
Kahele,70,63,133,0.5263157894736842,24
Kahili/Kāhili,22,20,42,0.5238095238095238,24
Kahinu,30,23,53,0.5660377358490566,24
Kahue,83,64,147,0.564625850340136,24
Kahuhu,18,22,40,0.45,24
Kaʻaeʻa,23,19,42,0.5476190476190477,24
Kaʻahanui,30,25,55,0.5454545454545454,24
Kaʻai,35,27,62,0.5645161290322581,24
Kaʻaihue,34,27,61,0.5573770491803278,24
Kaʻākau,34,35,69,0.4927536231884058,24
Kaʻanāʻanā,88,53,141,0.624113475177305,24
Kaʻaua/Kaʻauʻa,61,37,98,0.6224489795918368,24
Kaʻaukai,41,29,70,0.5857142857142857,24
Kaʻawa,32,21,53,0.6037735849056604,24
Kaʻili,58,36,94,0.6170212765957447,24
Kaʻilianu,24,27,51,0.47058823529411764,24
Kaiʻa,47,30,77,0.6103896103896104,24
Kaina,29,18,47,0.6170212765957447,24
Kaipo,28,14,42,0.6666666666666666,24
Kaiwi,56,41,97,0.5773195876288659,24
Kalā/Kala,33,16,49,0.673469387755102,24
Kalama,68,60,128,0.53125,24
Kalawaiʻa,60,39,99,0.6060606060606061,24
Kalehua,27,15,42,0.6428571428571429,24
Kalei,24,16,40,0.6,24
Kaleo,26,17,43,0.6046511627906976,24
Kalili,45,31,76,0.5921052631578947,24
Kalua,189,138,327,0.5779816513761468,24
Ahia,24,19,43,0.5581395348837209,25
Alapaʻi,26,26,52,0.5,25
Haʻaheo,18,19,37,0.4864864864864865,25
Hana,64,31,95,0.6736842105263158,25
Haole,22,24,46,0.4782608695652174,25
Hina,27,18,45,0.6,25
ʻEhu,23,24,47,0.48936170212765956,25
Kahananui,56,39,95,0.5894736842105263,25
Kaheana,51,30,81,0.6296296296296297,25
Kahele,71,62,133,0.5338345864661654,25
Kahili/Kāhili,29,13,42,0.6904761904761905,25
Kahinu,31,22,53,0.5849056603773585,25
Kahue,92,55,147,0.6258503401360545,25
Kahuhu,29,11,40,0.725,25
Kaʻaeʻa,24,18,42,0.5714285714285714,25
Kaʻahanui,30,25,55,0.5454545454545454,25
Kaʻai,34,28,62,0.5483870967741935,25
Kaʻaihue,33,28,61,0.5409836065573771,25
Kaʻākau,37,32,69,0.5362318840579711,25
Kaʻanāʻanā,75,66,141,0.5319148936170213,25
Kaʻaua/Kaʻauʻa,51,47,98,0.5204081632653061,25
Kaʻaukai,42,28,70,0.6,25
Kaʻawa,31,22,53,0.5849056603773585,25
Kaʻili,61,33,94,0.648936170212766,25
Kaʻilianu,31,20,51,0.6078431372549019,25
Kaiʻa,46,31,77,0.5974025974025974,25
Kaina,29,18,47,0.6170212765957447,25
Kaipo,22,20,42,0.5238095238095238,25
Kaiwi,53,44,97,0.5463917525773195,25
Kalā/Kala,38,11,49,0.7755102040816326,25
Kalama,74,54,128,0.578125,25
Kalawaiʻa,52,47,99,0.5252525252525253,25
Kalehua,28,14,42,0.6666666666666666,25
Kalei,22,18,40,0.55,25
Kaleo,22,21,43,0.5116279069767442,25
Kalili,41,35,76,0.5394736842105263,25
Kalua,195,132,327,0.5963302752293578,25
Ahia,23,20,43,0.5348837209302325,26
Alapaʻi,31,21,52,0.5961538461538461,26
Haʻaheo,20,17,37,0.5405405405405406,26
Hana,53,42,95,0.5578947368421052,26
Haole,25,21,46,0.5434782608695652,26
Hina,22,23,45,0.4888888888888889,26
ʻEhu,21,26,47,0.44680851063829785,26
Kahananui,52,43,95,0.5473684210526316,26
Kaheana,46,35,81,0.5679012345679012,26
Kahele,75,58,133,0.5639097744360902,26
Kahili/Kāhili,23,19,42,0.5476190476190477,26
Kahinu,21,32,53,0.39622641509433965,26
Kahue,94,53,147,0.6394557823129252,26
Kahuhu,25,15,40,0.625,26
Kaʻaeʻa,23,19,42,0.5476190476190477,26
Kaʻahanui,30,25,55,0.5454545454545454,26
Kaʻai,36,26,62,0.5806451612903226,26
Kaʻaihue,44,17,61,0.7213114754098361,26
Kaʻākau,36,33,69,0.5217391304347826,26
Kaʻanāʻanā,84,57,141,0.5957446808510638,26
Kaʻaua/Kaʻauʻa,67,31,98,0.6836734693877551,26
Kaʻaukai,45,25,70,0.6428571428571429,26
Kaʻawa,27,26,53,0.5094339622641509,26
Kaʻili,49,45,94,0.5212765957446809,26
Kaʻilianu,29,22,51,0.5686274509803921,26
Kaiʻa,58,19,77,0.7532467532467533,26
Kaina,26,21,47,0.5531914893617021,26
Kaipo,21,21,42,0.5,26
Kaiwi,56,41,97,0.5773195876288659,26
Kalā/Kala,28,21,49,0.5714285714285714,26
Kalama,81,47,128,0.6328125,26
Kalawaiʻa,54,45,99,0.5454545454545454,26
Kalehua,26,16,42,0.6190476190476191,26
Kalei,20,20,40,0.5,26
Kaleo,26,17,43,0.6046511627906976,26
Kalili,45,31,76,0.5921052631578947,26
Kalua,192,135,327,0.5871559633027523,26
Ahia,23,20,43,0.5348837209302325,27
Alapaʻi,29,23,52,0.5576923076923077,27
Haʻaheo,21,16,37,0.5675675675675675,27
Hana,53,42,95,0.5578947368421052,27
Haole,23,23,46,0.5,27
Hina,29,16,45,0.6444444444444445,27
ʻEhu,22,25,47,0.46808510638297873,27
Kahananui,50,45,95,0.5263157894736842,27
Kaheana,42,39,81,0.5185185185185185,27
Kahele,80,53,133,0.6015037593984962,27
Kahili/Kāhili,25,17,42,0.5952380952380952,27
Kahinu,32,21,53,0.6037735849056604,27
Kahue,83,64,147,0.564625850340136,27
Kahuhu,29,11,40,0.725,27
Kaʻaeʻa,18,24,42,0.42857142857142855,27
Kaʻahanui,32,23,55,0.5818181818181818,27
Kaʻai,37,25,62,0.5967741935483871,27
Kaʻaihue,40,21,61,0.6557377049180327,27
Kaʻākau,44,25,69,0.6376811594202898,27
Kaʻanāʻanā,78,63,141,0.5531914893617021,27
Kaʻaua/Kaʻauʻa,50,48,98,0.5102040816326531,27
Kaʻaukai,41,29,70,0.5857142857142857,27
Kaʻawa,32,21,53,0.6037735849056604,27
Kaʻili,56,38,94,0.5957446808510638,27
Kaʻilianu,27,24,51,0.5294117647058824,27
Kaiʻa,46,31,77,0.5974025974025974,27
Kaina,32,15,47,0.6808510638297872,27
Kaipo,23,19,42,0.5476190476190477,27
Kaiwi,57,40,97,0.5876288659793815,27
Kalā/Kala,23,26,49,0.46938775510204084,27
Kalama,80,48,128,0.625,27
Kalawaiʻa,63,36,99,0.6363636363636364,27
Kalehua,25,17,42,0.5952380952380952,27
Kalei,22,18,40,0.55,27
Kaleo,29,14,43,0.6744186046511628,27
Kalili,39,37,76,0.5131578947368421,27
Kalua,199,128,327,0.6085626911314985,27
Ahia,17,26,43,0.3953488372093023,28
Alapaʻi,28,24,52,0.5384615384615384,28
Haʻaheo,20,17,37,0.5405405405405406,28
Hana,49,46,95,0.5157894736842106,28
Haole,31,15,46,0.6739130434782609,28
Hina,27,18,45,0.6,28
ʻEhu,31,16,47,0.6595744680851063,28
Kahananui,59,36,95,0.6210526315789474,28
Kaheana,45,36,81,0.5555555555555556,28
Kahele,83,50,133,0.6240601503759399,28
Kahili/Kāhili,20,22,42,0.47619047619047616,28
Kahinu,31,22,53,0.5849056603773585,28
Kahue,91,56,147,0.6190476190476191,28
Kahuhu,24,16,40,0.6,28
Kaʻaeʻa,23,19,42,0.5476190476190477,28
Kaʻahanui,29,26,55,0.5272727272727272,28
Kaʻai,36,26,62,0.5806451612903226,28
Kaʻaihue,40,21,61,0.6557377049180327,28
Kaʻākau,36,33,69,0.5217391304347826,28
Kaʻanāʻanā,84,57,141,0.5957446808510638,28
Kaʻaua/Kaʻauʻa,51,47,98,0.5204081632653061,28
Kaʻaukai,45,25,70,0.6428571428571429,28
Kaʻawa,31,22,53,0.5849056603773585,28
Kaʻili,43,51,94,0.4574468085106383,28
Kaʻilianu,30,21,51,0.5882352941176471,28
Kaiʻa,46,31,77,0.5974025974025974,28
Kaina,26,21,47,0.5531914893617021,28
Kaipo,29,13,42,0.6904761904761905,28
Kaiwi,57,40,97,0.5876288659793815,28
Kalā/Kala,27,22,49,0.5510204081632653,28
Kalama,84,44,128,0.65625,28
Kalawaiʻa,60,39,99,0.6060606060606061,28
Kalehua,27,15,42,0.6428571428571429,28
Kalei,22,18,40,0.55,28
Kaleo,27,16,43,0.627906976744186,28
Kalili,45,31,76,0.5921052631578947,28
Kalua,180,147,327,0.5504587155963303,28
Ahia,26,17,43,0.6046511627906976,29
Alapaʻi,26,26,52,0.5,29
Haʻaheo,22,15,37,0.5945945945945946,29
Hana,51,44,95,0.5368421052631579,29
Haole,27,19,46,0.5869565217391305,29
Hina,27,18,45,0.6,29
ʻEhu,26,21,47,0.5531914893617021,29
Kahananui,56,39,95,0.5894736842105263,29
Kaheana,50,31,81,0.6172839506172839,29
Kahele,79,54,133,0.5939849624060151,29
Kahili/Kāhili,27,15,42,0.6428571428571429,29
Kahinu,33,20,53,0.6226415094339622,29
Kahue,85,62,147,0.5782312925170068,29
Kahuhu,26,14,40,0.65,29
Kaʻaeʻa,22,20,42,0.5238095238095238,29
Kaʻahanui,34,21,55,0.6181818181818182,29
Kaʻai,32,30,62,0.5161290322580645,29
Kaʻaihue,32,29,61,0.5245901639344263,29
Kaʻākau,35,34,69,0.5072463768115942,29
Kaʻanāʻanā,82,59,141,0.5815602836879432,29
Kaʻaua/Kaʻauʻa,59,39,98,0.6020408163265306,29
Kaʻaukai,40,30,70,0.5714285714285714,29
Kaʻawa,31,22,53,0.5849056603773585,29
Kaʻili,56,38,94,0.5957446808510638,29
Kaʻilianu,33,18,51,0.6470588235294118,29
Kaiʻa,47,30,77,0.6103896103896104,29
Kaina,27,20,47,0.574468085106383,29
Kaipo,29,13,42,0.6904761904761905,29
Kaiwi,55,42,97,0.5670103092783505,29
Kalā/Kala,34,15,49,0.6938775510204082,29
Kalama,65,63,128,0.5078125,29
Kalawaiʻa,57,42,99,0.5757575757575758,29
Kalehua,26,16,42,0.6190476190476191,29
Kalei,21,19,40,0.525,29
Kaleo,33,10,43,0.7674418604651163,29
Kalili,42,34,76,0.5526315789473685,29
Kalua,181,146,327,0.5535168195718655,29
Ahia,24,19,43,0.5581395348837209,30
Alapaʻi,36,16,52,0.6923076923076923,30
Haʻaheo,21,16,37,0.5675675675675675,30
Hana,54,41,95,0.5684210526315789,30
Haole,32,14,46,0.6956521739130435,30
Hina,34,11,45,0.7555555555555555,30
ʻEhu,23,24,47,0.48936170212765956,30
Kahananui,56,39,95,0.5894736842105263,30
Kaheana,42,39,81,0.5185185185185185,30
Kahele,65,68,133,0.48872180451127817,30
Kahili/Kāhili,22,20,42,0.5238095238095238,30
Kahinu,34,19,53,0.6415094339622641,30
Kahue,88,59,147,0.5986394557823129,30
Kahuhu,22,18,40,0.55,30
Kaʻaeʻa,26,16,42,0.6190476190476191,30
Kaʻahanui,28,27,55,0.509090909090909,30
Kaʻai,39,23,62,0.6290322580645161,30
Kaʻaihue,39,22,61,0.639344262295082,30
Kaʻākau,42,27,69,0.6086956521739131,30
Kaʻanāʻanā,73,68,141,0.5177304964539007,30
Kaʻaua/Kaʻauʻa,49,49,98,0.5,30
Kaʻaukai,42,28,70,0.6,30
Kaʻawa,29,24,53,0.5471698113207547,30
Kaʻili,51,43,94,0.5425531914893617,30
Kaʻilianu,25,26,51,0.49019607843137253,30
Kaiʻa,47,30,77,0.6103896103896104,30
Kaina,33,14,47,0.7021276595744681,30
Kaipo,25,17,42,0.5952380952380952,30
Kaiwi,65,32,97,0.6701030927835051,30
Kalā/Kala,33,16,49,0.673469387755102,30
Kalama,74,54,128,0.578125,30
Kalawaiʻa,47,52,99,0.47474747474747475,30
Kalehua,25,17,42,0.5952380952380952,30
Kalei,25,15,40,0.625,30
Kaleo,24,19,43,0.5581395348837209,30
Kalili,42,34,76,0.5526315789473685,30
Kalua,198,129,327,0.6055045871559633,30
Ahia,26,17,43,0.6046511627906976,31
Alapaʻi,34,18,52,0.6538461538461539,31
Haʻaheo,19,18,37,0.5135135135135135,31
Hana,65,30,95,0.6842105263157895,31
Haole,26,20,46,0.5652173913043478,31
Hina,23,22,45,0.5111111111111111,31
ʻEhu,25,22,47,0.5319148936170213,31
Kahananui,55,40,95,0.5789473684210527,31
Kaheana,51,30,81,0.6296296296296297,31
Kahele,74,59,133,0.556390977443609,31
Kahili/Kāhili,24,18,42,0.5714285714285714,31
Kahinu,36,17,53,0.6792452830188679,31
Kahue,83,64,147,0.564625850340136,31
Kahuhu,23,17,40,0.575,31
Kaʻaeʻa,28,14,42,0.6666666666666666,31
Kaʻahanui,30,25,55,0.5454545454545454,31
Kaʻai,31,31,62,0.5,31
Kaʻaihue,35,26,61,0.5737704918032787,31
Kaʻākau,43,26,69,0.6231884057971014,31
Kaʻanāʻanā,77,64,141,0.5460992907801419,31
Kaʻaua/Kaʻauʻa,60,38,98,0.6122448979591837,31
Kaʻaukai,49,21,70,0.7,31
Kaʻawa,30,23,53,0.5660377358490566,31
Kaʻili,65,29,94,0.6914893617021277,31
Kaʻilianu,31,20,51,0.6078431372549019,31
Kaiʻa,45,32,77,0.5844155844155844,31
Kaina,25,22,47,0.5319148936170213,31
Kaipo,26,16,42,0.6190476190476191,31
Kaiwi,64,33,97,0.6597938144329897,31
Kalā/Kala,29,20,49,0.5918367346938775,31
Kalama,66,62,128,0.515625,31
Kalawaiʻa,55,44,99,0.5555555555555556,31
Kalehua,25,17,42,0.5952380952380952,31
Kalei,23,17,40,0.575,31
Kaleo,19,24,43,0.4418604651162791,31
Kalili,45,31,76,0.5921052631578947,31
Kalua,169,158,327,0.5168195718654435,31
Ahia,30,13,43,0.6976744186046512,32
Alapaʻi,37,15,52,0.7115384615384616,32
Haʻaheo,25,12,37,0.6756756756756757,32
Hana,61,34,95,0.6421052631578947,32
Haole,17,29,46,0.3695652173913043,32
Hina,23,22,45,0.5111111111111111,32
ʻEhu,22,25,47,0.46808510638297873,32
Kahananui,55,40,95,0.5789473684210527,32
Kaheana,48,33,81,0.5925925925925926,32
Kahele,83,50,133,0.6240601503759399,32
Kahili/Kāhili,22,20,42,0.5238095238095238,32
Kahinu,34,19,53,0.6415094339622641,32
Kahue,77,70,147,0.5238095238095238,32
Kahuhu,25,15,40,0.625,32
Kaʻaeʻa,22,20,42,0.5238095238095238,32
Kaʻahanui,34,21,55,0.6181818181818182,32
Kaʻai,34,28,62,0.5483870967741935,32
Kaʻaihue,33,28,61,0.5409836065573771,32
Kaʻākau,36,33,69,0.5217391304347826,32
Kaʻanāʻanā,82,59,141,0.5815602836879432,32
Kaʻaua/Kaʻauʻa,54,44,98,0.5510204081632653,32
Kaʻaukai,40,30,70,0.5714285714285714,32
Kaʻawa,31,22,53,0.5849056603773585,32
Kaʻili,55,39,94,0.5851063829787234,32
Kaʻilianu,38,13,51,0.7450980392156863,32
Kaiʻa,47,30,77,0.6103896103896104,32
Kaina,29,18,47,0.6170212765957447,32
Kaipo,21,21,42,0.5,32
Kaiwi,50,47,97,0.5154639175257731,32
Kalā/Kala,27,22,49,0.5510204081632653,32
Kalama,86,42,128,0.671875,32
Kalawaiʻa,60,39,99,0.6060606060606061,32
Kalehua,28,14,42,0.6666666666666666,32
Kalei,19,21,40,0.475,32
Kaleo,21,22,43,0.4883720930232558,32
Kalili,43,33,76,0.5657894736842105,32
Kalua,185,142,327,0.5657492354740061,32
Ahia,23,20,43,0.5348837209302325,33
Alapaʻi,27,25,52,0.5192307692307693,33
Haʻaheo,22,15,37,0.5945945945945946,33
Hana,50,45,95,0.5263157894736842,33
Haole,32,14,46,0.6956521739130435,33
Hina,28,17,45,0.6222222222222222,33
ʻEhu,18,29,47,0.3829787234042553,33
Kahananui,49,46,95,0.5157894736842106,33
Kaheana,47,34,81,0.5802469135802469,33
Kahele,78,55,133,0.5864661654135338,33
Kahili/Kāhili,22,20,42,0.5238095238095238,33
Kahinu,33,20,53,0.6226415094339622,33
Kahue,87,60,147,0.5918367346938775,33
Kahuhu,21,19,40,0.525,33
Kaʻaeʻa,23,19,42,0.5476190476190477,33
Kaʻahanui,29,26,55,0.5272727272727272,33
Kaʻai,36,26,62,0.5806451612903226,33
Kaʻaihue,37,24,61,0.6065573770491803,33
Kaʻākau,38,31,69,0.5507246376811594,33
Kaʻanāʻanā,79,62,141,0.5602836879432624,33
Kaʻaua/Kaʻauʻa,64,34,98,0.6530612244897959,33
Kaʻaukai,47,23,70,0.6714285714285714,33
Kaʻawa,36,17,53,0.6792452830188679,33
Kaʻili,59,35,94,0.6276595744680851,33
Kaʻilianu,26,25,51,0.5098039215686274,33
Kaiʻa,40,37,77,0.5194805194805194,33
Kaina,23,24,47,0.48936170212765956,33
Kaipo,25,17,42,0.5952380952380952,33
Kaiwi,57,40,97,0.5876288659793815,33
Kalā/Kala,29,20,49,0.5918367346938775,33
Kalama,81,47,128,0.6328125,33
Kalawaiʻa,61,38,99,0.6161616161616161,33
Kalehua,21,21,42,0.5,33
Kalei,20,20,40,0.5,33
Kaleo,26,17,43,0.6046511627906976,33
Kalili,49,27,76,0.6447368421052632,33
Kalua,191,136,327,0.5840978593272171,33
Ahia,24,19,43,0.5581395348837209,34
Alapaʻi,30,22,52,0.5769230769230769,34
Haʻaheo,26,11,37,0.7027027027027027,34
Hana,54,41,95,0.5684210526315789,34
Haole,30,16,46,0.6521739130434783,34
Hina,21,24,45,0.4666666666666667,34
ʻEhu,23,24,47,0.48936170212765956,34
Kahananui,55,40,95,0.5789473684210527,34
Kaheana,50,31,81,0.6172839506172839,34
Kahele,73,60,133,0.5488721804511278,34
Kahili/Kāhili,23,19,42,0.5476190476190477,34
Kahinu,28,25,53,0.5283018867924528,34
Kahue,93,54,147,0.6326530612244898,34
Kahuhu,23,17,40,0.575,34
Kaʻaeʻa,20,22,42,0.47619047619047616,34
Kaʻahanui,35,20,55,0.6363636363636364,34
Kaʻai,40,22,62,0.6451612903225806,34
Kaʻaihue,38,23,61,0.6229508196721312,34
Kaʻākau,47,22,69,0.6811594202898551,34
Kaʻanāʻanā,78,63,141,0.5531914893617021,34
Kaʻaua/Kaʻauʻa,53,45,98,0.5408163265306123,34
Kaʻaukai,46,24,70,0.6571428571428571,34
Kaʻawa,29,24,53,0.5471698113207547,34
Kaʻili,61,33,94,0.648936170212766,34
Kaʻilianu,33,18,51,0.6470588235294118,34
Kaiʻa,50,27,77,0.6493506493506493,34
Kaina,25,22,47,0.5319148936170213,34
Kaipo,23,19,42,0.5476190476190477,34
Kaiwi,57,40,97,0.5876288659793815,34
Kalā/Kala,29,20,49,0.5918367346938775,34
Kalama,65,63,128,0.5078125,34
Kalawaiʻa,63,36,99,0.6363636363636364,34
Kalehua,27,15,42,0.6428571428571429,34
Kalei,20,20,40,0.5,34
Kaleo,23,20,43,0.5348837209302325,34
Kalili,50,26,76,0.6578947368421053,34
Kalua,169,158,327,0.5168195718654435,34
Ahia,28,15,43,0.6511627906976745,35
Alapaʻi,32,20,52,0.6153846153846154,35
Haʻaheo,26,11,37,0.7027027027027027,35
Hana,56,39,95,0.5894736842105263,35
Haole,29,17,46,0.6304347826086957,35
Hina,26,19,45,0.5777777777777777,35
ʻEhu,28,19,47,0.5957446808510638,35
Kahananui,53,42,95,0.5578947368421052,35
Kaheana,46,35,81,0.5679012345679012,35
Kahele,72,61,133,0.5413533834586466,35
Kahili/Kāhili,28,14,42,0.6666666666666666,35
Kahinu,25,28,53,0.4716981132075472,35
Kahue,85,62,147,0.5782312925170068,35
Kahuhu,19,21,40,0.475,35
Kaʻaeʻa,23,19,42,0.5476190476190477,35
Kaʻahanui,32,23,55,0.5818181818181818,35
Kaʻai,40,22,62,0.6451612903225806,35
Kaʻaihue,39,22,61,0.639344262295082,35
Kaʻākau,36,33,69,0.5217391304347826,35
Kaʻanāʻanā,85,56,141,0.6028368794326241,35
Kaʻaua/Kaʻauʻa,51,47,98,0.5204081632653061,35
Kaʻaukai,39,31,70,0.5571428571428572,35
Kaʻawa,36,17,53,0.6792452830188679,35
Kaʻili,43,51,94,0.4574468085106383,35
Kaʻilianu,32,19,51,0.6274509803921569,35
Kaiʻa,47,30,77,0.6103896103896104,35
Kaina,29,18,47,0.6170212765957447,35
Kaipo,24,18,42,0.5714285714285714,35
Kaiwi,59,38,97,0.6082474226804123,35
Kalā/Kala,25,24,49,0.5102040816326531,35
Kalama,81,47,128,0.6328125,35
Kalawaiʻa,60,39,99,0.6060606060606061,35
Kalehua,30,12,42,0.7142857142857143,35
Kalei,26,14,40,0.65,35
Kaleo,24,19,43,0.5581395348837209,35
Kalili,38,38,76,0.5,35
Kalua,182,145,327,0.5565749235474006,35
Ahia,30,13,43,0.6976744186046512,36
Alapaʻi,32,20,52,0.6153846153846154,36
Haʻaheo,15,22,37,0.40540540540540543,36
Hana,61,34,95,0.6421052631578947,36
Haole,22,24,46,0.4782608695652174,36
Hina,24,21,45,0.5333333333333333,36
ʻEhu,28,19,47,0.5957446808510638,36
Kahananui,60,35,95,0.631578947368421,36
Kaheana,45,36,81,0.5555555555555556,36
Kahele,76,57,133,0.5714285714285714,36
Kahili/Kāhili,23,19,42,0.5476190476190477,36
Kahinu,31,22,53,0.5849056603773585,36
Kahue,83,64,147,0.564625850340136,36
Kahuhu,31,9,40,0.775,36
Kaʻaeʻa,26,16,42,0.6190476190476191,36
Kaʻahanui,34,21,55,0.6181818181818182,36
Kaʻai,30,32,62,0.4838709677419355,36
Kaʻaihue,33,28,61,0.5409836065573771,36
Kaʻākau,41,28,69,0.5942028985507246,36
Kaʻanāʻanā,80,61,141,0.5673758865248227,36
Kaʻaua/Kaʻauʻa,60,38,98,0.6122448979591837,36
Kaʻaukai,45,25,70,0.6428571428571429,36
Kaʻawa,36,17,53,0.6792452830188679,36
Kaʻili,53,41,94,0.5638297872340425,36
Kaʻilianu,27,24,51,0.5294117647058824,36
Kaiʻa,44,33,77,0.5714285714285714,36
Kaina,30,17,47,0.6382978723404256,36
Kaipo,19,23,42,0.4523809523809524,36
Kaiwi,58,39,97,0.5979381443298969,36
Kalā/Kala,19,30,49,0.3877551020408163,36
Kalama,71,57,128,0.5546875,36
Kalawaiʻa,55,44,99,0.5555555555555556,36
Kalehua,23,19,42,0.5476190476190477,36
Kalei,21,19,40,0.525,36
Kaleo,24,19,43,0.5581395348837209,36
Kalili,44,32,76,0.5789473684210527,36
Kalua,200,127,327,0.6116207951070336,36
Ahia,22,21,43,0.5116279069767442,37
Alapaʻi,29,23,52,0.5576923076923077,37
Haʻaheo,26,11,37,0.7027027027027027,37
Hana,66,29,95,0.6947368421052632,37
Haole,28,18,46,0.6086956521739131,37
Hina,28,17,45,0.6222222222222222,37
ʻEhu,29,18,47,0.6170212765957447,37
Kahananui,62,33,95,0.6526315789473685,37
Kaheana,48,33,81,0.5925925925925926,37
Kahele,75,58,133,0.5639097744360902,37
Kahili/Kāhili,30,12,42,0.7142857142857143,37
Kahinu,28,25,53,0.5283018867924528,37
Kahue,88,59,147,0.5986394557823129,37
Kahuhu,17,23,40,0.425,37
Kaʻaeʻa,26,16,42,0.6190476190476191,37
Kaʻahanui,28,27,55,0.509090909090909,37
Kaʻai,33,29,62,0.532258064516129,37
Kaʻaihue,38,23,61,0.6229508196721312,37
Kaʻākau,34,35,69,0.4927536231884058,37
Kaʻanāʻanā,74,67,141,0.524822695035461,37
Kaʻaua/Kaʻauʻa,60,38,98,0.6122448979591837,37
Kaʻaukai,42,28,70,0.6,37
Kaʻawa,26,27,53,0.49056603773584906,37
Kaʻili,54,40,94,0.574468085106383,37
Kaʻilianu,32,19,51,0.6274509803921569,37
Kaiʻa,39,38,77,0.5064935064935064,37
Kaina,28,19,47,0.5957446808510638,37
Kaipo,25,17,42,0.5952380952380952,37
Kaiwi,56,41,97,0.5773195876288659,37
Kalā/Kala,24,25,49,0.4897959183673469,37
Kalama,85,43,128,0.6640625,37
Kalawaiʻa,57,42,99,0.5757575757575758,37
Kalehua,24,18,42,0.5714285714285714,37
Kalei,22,18,40,0.55,37
Kaleo,24,19,43,0.5581395348837209,37
Kalili,42,34,76,0.5526315789473685,37
Kalua,185,142,327,0.5657492354740061,37
Ahia,24,19,43,0.5581395348837209,38
Alapaʻi,29,23,52,0.5576923076923077,38
Haʻaheo,21,16,37,0.5675675675675675,38
Hana,61,34,95,0.6421052631578947,38
Haole,28,18,46,0.6086956521739131,38
Hina,25,20,45,0.5555555555555556,38
ʻEhu,28,19,47,0.5957446808510638,38
Kahananui,54,41,95,0.5684210526315789,38
Kaheana,47,34,81,0.5802469135802469,38
Kahele,70,63,133,0.5263157894736842,38
Kahili/Kāhili,20,22,42,0.47619047619047616,38
Kahinu,31,22,53,0.5849056603773585,38
Kahue,80,67,147,0.54421768707483,38
Kahuhu,18,22,40,0.45,38
Kaʻaeʻa,24,18,42,0.5714285714285714,38
Kaʻahanui,34,21,55,0.6181818181818182,38
Kaʻai,40,22,62,0.6451612903225806,38
Kaʻaihue,39,22,61,0.639344262295082,38
Kaʻākau,40,29,69,0.5797101449275363,38
Kaʻanāʻanā,84,57,141,0.5957446808510638,38
Kaʻaua/Kaʻauʻa,52,46,98,0.5306122448979592,38
Kaʻaukai,42,28,70,0.6,38
Kaʻawa,25,28,53,0.4716981132075472,38
Kaʻili,57,37,94,0.6063829787234043,38
Kaʻilianu,29,22,51,0.5686274509803921,38
Kaiʻa,46,31,77,0.5974025974025974,38
Kaina,29,18,47,0.6170212765957447,38
Kaipo,25,17,42,0.5952380952380952,38
Kaiwi,54,43,97,0.5567010309278351,38
Kalā/Kala,23,26,49,0.46938775510204084,38
Kalama,83,45,128,0.6484375,38
Kalawaiʻa,60,39,99,0.6060606060606061,38
Kalehua,29,13,42,0.6904761904761905,38
Kalei,26,14,40,0.65,38
Kaleo,28,15,43,0.6511627906976745,38
Kalili,47,29,76,0.618421052631579,38
Kalua,182,145,327,0.5565749235474006,38
Ahia,23,20,43,0.5348837209302325,39
Alapaʻi,39,13,52,0.75,39
Haʻaheo,21,16,37,0.5675675675675675,39
Hana,53,42,95,0.5578947368421052,39
Haole,29,17,46,0.6304347826086957,39
Hina,31,14,45,0.6888888888888889,39
ʻEhu,29,18,47,0.6170212765957447,39
Kahananui,57,38,95,0.6,39
Kaheana,46,35,81,0.5679012345679012,39
Kahele,87,46,133,0.6541353383458647,39
Kahili/Kāhili,19,23,42,0.4523809523809524,39
Kahinu,31,22,53,0.5849056603773585,39
Kahue,73,74,147,0.4965986394557823,39
Kahuhu,25,15,40,0.625,39
Kaʻaeʻa,22,20,42,0.5238095238095238,39
Kaʻahanui,35,20,55,0.6363636363636364,39
Kaʻai,39,23,62,0.6290322580645161,39
Kaʻaihue,37,24,61,0.6065573770491803,39
Kaʻākau,42,27,69,0.6086956521739131,39
Kaʻanāʻanā,85,56,141,0.6028368794326241,39
Kaʻaua/Kaʻauʻa,46,52,98,0.46938775510204084,39
Kaʻaukai,48,22,70,0.6857142857142857,39
Kaʻawa,34,19,53,0.6415094339622641,39
Kaʻili,49,45,94,0.5212765957446809,39
Kaʻilianu,30,21,51,0.5882352941176471,39
Kaiʻa,38,39,77,0.4935064935064935,39
Kaina,26,21,47,0.5531914893617021,39
Kaipo,25,17,42,0.5952380952380952,39
Kaiwi,69,28,97,0.711340206185567,39
Kalā/Kala,35,14,49,0.7142857142857143,39
Kalama,71,57,128,0.5546875,39
Kalawaiʻa,53,46,99,0.5353535353535354,39
Kalehua,22,20,42,0.5238095238095238,39
Kalei,23,17,40,0.575,39
Kaleo,20,23,43,0.46511627906976744,39
Kalili,41,35,76,0.5394736842105263,39
Kalua,181,146,327,0.5535168195718655,39
Ahia,25,18,43,0.5813953488372093,40
Alapaʻi,28,24,52,0.5384615384615384,40
Haʻaheo,21,16,37,0.5675675675675675,40
Hana,58,37,95,0.6105263157894737,40
Haole,25,21,46,0.5434782608695652,40
Hina,31,14,45,0.6888888888888889,40
ʻEhu,28,19,47,0.5957446808510638,40
Kahananui,57,38,95,0.6,40
Kaheana,40,41,81,0.49382716049382713,40
Kahele,71,62,133,0.5338345864661654,40
Kahili/Kāhili,24,18,42,0.5714285714285714,40
Kahinu,36,17,53,0.6792452830188679,40
Kahue,83,64,147,0.564625850340136,40
Kahuhu,25,15,40,0.625,40
Kaʻaeʻa,26,16,42,0.6190476190476191,40
Kaʻahanui,27,28,55,0.4909090909090909,40
Kaʻai,33,29,62,0.532258064516129,40
Kaʻaihue,32,29,61,0.5245901639344263,40
Kaʻākau,43,26,69,0.6231884057971014,40
Kaʻanāʻanā,93,48,141,0.6595744680851063,40
Kaʻaua/Kaʻauʻa,59,39,98,0.6020408163265306,40
Kaʻaukai,40,30,70,0.5714285714285714,40
Kaʻawa,25,28,53,0.4716981132075472,40
Kaʻili,50,44,94,0.5319148936170213,40
Kaʻilianu,28,23,51,0.5490196078431373,40
Kaiʻa,39,38,77,0.5064935064935064,40
Kaina,31,16,47,0.6595744680851063,40
Kaipo,24,18,42,0.5714285714285714,40
Kaiwi,62,35,97,0.6391752577319587,40
Kalā/Kala,28,21,49,0.5714285714285714,40
Kalama,68,60,128,0.53125,40
Kalawaiʻa,64,35,99,0.6464646464646465,40
Kalehua,26,16,42,0.6190476190476191,40
Kalei,26,14,40,0.65,40
Kaleo,25,18,43,0.5813953488372093,40
Kalili,50,26,76,0.6578947368421053,40
Kalua,183,144,327,0.5596330275229358,40
Ahia,25,18,43,0.5813953488372093,41
Alapaʻi,30,22,52,0.5769230769230769,41
Haʻaheo,17,20,37,0.4594594594594595,41
Hana,47,48,95,0.49473684210526314,41
Haole,21,25,46,0.45652173913043476,41
Hina,29,16,45,0.6444444444444445,41
ʻEhu,30,17,47,0.6382978723404256,41
Kahananui,57,38,95,0.6,41
Kaheana,50,31,81,0.6172839506172839,41
Kahele,79,54,133,0.5939849624060151,41
Kahili/Kāhili,26,16,42,0.6190476190476191,41
Kahinu,30,23,53,0.5660377358490566,41
Kahue,86,61,147,0.5850340136054422,41
Kahuhu,27,13,40,0.675,41
Kaʻaeʻa,24,18,42,0.5714285714285714,41
Kaʻahanui,26,29,55,0.4727272727272727,41
Kaʻai,40,22,62,0.6451612903225806,41
Kaʻaihue,39,22,61,0.639344262295082,41
Kaʻākau,38,31,69,0.5507246376811594,41
Kaʻanāʻanā,78,63,141,0.5531914893617021,41
Kaʻaua/Kaʻauʻa,58,40,98,0.5918367346938775,41
Kaʻaukai,37,33,70,0.5285714285714286,41
Kaʻawa,34,19,53,0.6415094339622641,41
Kaʻili,60,34,94,0.6382978723404256,41
Kaʻilianu,32,19,51,0.6274509803921569,41
Kaiʻa,48,29,77,0.6233766233766234,41
Kaina,24,23,47,0.5106382978723404,41
Kaipo,21,21,42,0.5,41
Kaiwi,58,39,97,0.5979381443298969,41
Kalā/Kala,25,24,49,0.5102040816326531,41
Kalama,81,47,128,0.6328125,41
Kalawaiʻa,54,45,99,0.5454545454545454,41
Kalehua,27,15,42,0.6428571428571429,41
Kalei,23,17,40,0.575,41
Kaleo,21,22,43,0.4883720930232558,41
Kalili,36,40,76,0.47368421052631576,41
Kalua,196,131,327,0.599388379204893,41
Ahia,23,20,43,0.5348837209302325,42
Alapaʻi,31,21,52,0.5961538461538461,42
Haʻaheo,15,22,37,0.40540540540540543,42
Hana,53,42,95,0.5578947368421052,42
Haole,23,23,46,0.5,42
Hina,27,18,45,0.6,42
ʻEhu,31,16,47,0.6595744680851063,42
Kahananui,55,40,95,0.5789473684210527,42
Kaheana,45,36,81,0.5555555555555556,42
Kahele,79,54,133,0.5939849624060151,42
Kahili/Kāhili,27,15,42,0.6428571428571429,42
Kahinu,31,22,53,0.5849056603773585,42
Kahue,84,63,147,0.5714285714285714,42
Kahuhu,26,14,40,0.65,42
Kaʻaeʻa,25,17,42,0.5952380952380952,42
Kaʻahanui,29,26,55,0.5272727272727272,42
Kaʻai,41,21,62,0.6612903225806451,42
Kaʻaihue,32,29,61,0.5245901639344263,42
Kaʻākau,40,29,69,0.5797101449275363,42
Kaʻanāʻanā,84,57,141,0.5957446808510638,42
Kaʻaua/Kaʻauʻa,56,42,98,0.5714285714285714,42
Kaʻaukai,41,29,70,0.5857142857142857,42
Kaʻawa,33,20,53,0.6226415094339622,42
Kaʻili,54,40,94,0.574468085106383,42
Kaʻilianu,27,24,51,0.5294117647058824,42
Kaiʻa,45,32,77,0.5844155844155844,42
Kaina,30,17,47,0.6382978723404256,42
Kaipo,25,17,42,0.5952380952380952,42
Kaiwi,55,42,97,0.5670103092783505,42
Kalā/Kala,33,16,49,0.673469387755102,42
Kalama,73,55,128,0.5703125,42
Kalawaiʻa,57,42,99,0.5757575757575758,42
Kalehua,25,17,42,0.5952380952380952,42
Kalei,24,16,40,0.6,42
Kaleo,25,18,43,0.5813953488372093,42
Kalili,40,36,76,0.5263157894736842,42
Kalua,190,137,327,0.581039755351682,42
Ahia,24,19,43,0.5581395348837209,43
Alapaʻi,31,21,52,0.5961538461538461,43
Haʻaheo,19,18,37,0.5135135135135135,43
Hana,52,43,95,0.5473684210526316,43
Haole,24,22,46,0.5217391304347826,43
Hina,23,22,45,0.5111111111111111,43
ʻEhu,34,13,47,0.723404255319149,43
Kahananui,52,43,95,0.5473684210526316,43
Kaheana,38,43,81,0.4691358024691358,43
Kahele,76,57,133,0.5714285714285714,43
Kahili/Kāhili,28,14,42,0.6666666666666666,43
Kahinu,27,26,53,0.5094339622641509,43
Kahue,81,66,147,0.5510204081632653,43
Kahuhu,25,15,40,0.625,43
Kaʻaeʻa,23,19,42,0.5476190476190477,43
Kaʻahanui,37,18,55,0.6727272727272727,43
Kaʻai,37,25,62,0.5967741935483871,43
Kaʻaihue,39,22,61,0.639344262295082,43
Kaʻākau,49,20,69,0.7101449275362319,43
Kaʻanāʻanā,84,57,141,0.5957446808510638,43
Kaʻaua/Kaʻauʻa,46,52,98,0.46938775510204084,43
Kaʻaukai,36,34,70,0.5142857142857142,43
Kaʻawa,30,23,53,0.5660377358490566,43
Kaʻili,66,28,94,0.7021276595744681,43
Kaʻilianu,30,21,51,0.5882352941176471,43
Kaiʻa,41,36,77,0.5324675324675324,43
Kaina,31,16,47,0.6595744680851063,43
Kaipo,30,12,42,0.7142857142857143,43
Kaiwi,61,36,97,0.6288659793814433,43
Kalā/Kala,25,24,49,0.5102040816326531,43
Kalama,66,62,128,0.515625,43
Kalawaiʻa,60,39,99,0.6060606060606061,43
Kalehua,21,21,42,0.5,43
Kalei,18,22,40,0.45,43
Kaleo,24,19,43,0.5581395348837209,43
Kalili,40,36,76,0.5263157894736842,43
Kalua,206,121,327,0.6299694189602446,43
Ahia,19,24,43,0.4418604651162791,44
Alapaʻi,29,23,52,0.5576923076923077,44
Haʻaheo,25,12,37,0.6756756756756757,44
Hana,49,46,95,0.5157894736842106,44
Haole,28,18,46,0.6086956521739131,44
Hina,22,23,45,0.4888888888888889,44
ʻEhu,28,19,47,0.5957446808510638,44
Kahananui,41,54,95,0.43157894736842106,44
Kaheana,41,40,81,0.5061728395061729,44
Kahele,81,52,133,0.6090225563909775,44
Kahili/Kāhili,23,19,42,0.5476190476190477,44
Kahinu,30,23,53,0.5660377358490566,44
Kahue,86,61,147,0.5850340136054422,44
Kahuhu,26,14,40,0.65,44
Kaʻaeʻa,29,13,42,0.6904761904761905,44
Kaʻahanui,36,19,55,0.6545454545454545,44
Kaʻai,36,26,62,0.5806451612903226,44
Kaʻaihue,37,24,61,0.6065573770491803,44
Kaʻākau,37,32,69,0.5362318840579711,44
Kaʻanāʻanā,85,56,141,0.6028368794326241,44
Kaʻaua/Kaʻauʻa,56,42,98,0.5714285714285714,44
Kaʻaukai,41,29,70,0.5857142857142857,44
Kaʻawa,28,25,53,0.5283018867924528,44
Kaʻili,48,46,94,0.5106382978723404,44
Kaʻilianu,28,23,51,0.5490196078431373,44
Kaiʻa,50,27,77,0.6493506493506493,44
Kaina,27,20,47,0.574468085106383,44
Kaipo,25,17,42,0.5952380952380952,44
Kaiwi,57,40,97,0.5876288659793815,44
Kalā/Kala,34,15,49,0.6938775510204082,44
Kalama,78,50,128,0.609375,44
Kalawaiʻa,57,42,99,0.5757575757575758,44
Kalehua,25,17,42,0.5952380952380952,44
Kalei,20,20,40,0.5,44
Kaleo,25,18,43,0.5813953488372093,44
Kalili,46,30,76,0.6052631578947368,44
Kalua,201,126,327,0.6146788990825688,44
Ahia,27,16,43,0.627906976744186,45
Alapaʻi,37,15,52,0.7115384615384616,45
Haʻaheo,24,13,37,0.6486486486486487,45
Hana,57,38,95,0.6,45
Haole,18,28,46,0.391304347826087,45
Hina,18,27,45,0.4,45
ʻEhu,31,16,47,0.6595744680851063,45
Kahananui,64,31,95,0.6736842105263158,45
Kaheana,46,35,81,0.5679012345679012,45
Kahele,73,60,133,0.5488721804511278,45
Kahili/Kāhili,28,14,42,0.6666666666666666,45
Kahinu,33,20,53,0.6226415094339622,45
Kahue,82,65,147,0.5578231292517006,45
Kahuhu,27,13,40,0.675,45
Kaʻaeʻa,23,19,42,0.5476190476190477,45
Kaʻahanui,29,26,55,0.5272727272727272,45
Kaʻai,46,16,62,0.7419354838709677,45
Kaʻaihue,31,30,61,0.5081967213114754,45
Kaʻākau,32,37,69,0.463768115942029,45
Kaʻanāʻanā,79,62,141,0.5602836879432624,45
Kaʻaua/Kaʻauʻa,56,42,98,0.5714285714285714,45
Kaʻaukai,42,28,70,0.6,45
Kaʻawa,37,16,53,0.6981132075471698,45
Kaʻili,58,36,94,0.6170212765957447,45
Kaʻilianu,24,27,51,0.47058823529411764,45
Kaiʻa,38,39,77,0.4935064935064935,45
Kaina,29,18,47,0.6170212765957447,45
Kaipo,32,10,42,0.7619047619047619,45
Kaiwi,59,38,97,0.6082474226804123,45
Kalā/Kala,25,24,49,0.5102040816326531,45
Kalama,79,49,128,0.6171875,45
Kalawaiʻa,50,49,99,0.5050505050505051,45
Kalehua,23,19,42,0.5476190476190477,45
Kalei,27,13,40,0.675,45
Kaleo,22,21,43,0.5116279069767442,45
Kalili,46,30,76,0.6052631578947368,45
Kalua,182,145,327,0.5565749235474006,45
Ahia,23,20,43,0.5348837209302325,46
Alapaʻi,25,27,52,0.4807692307692308,46
Haʻaheo,20,17,37,0.5405405405405406,46
Hana,56,39,95,0.5894736842105263,46
Haole,26,20,46,0.5652173913043478,46
Hina,26,19,45,0.5777777777777777,46
ʻEhu,27,20,47,0.574468085106383,46
Kahananui,54,41,95,0.5684210526315789,46
Kaheana,49,32,81,0.6049382716049383,46
Kahele,67,66,133,0.5037593984962406,46
Kahili/Kāhili,29,13,42,0.6904761904761905,46
Kahinu,33,20,53,0.6226415094339622,46
Kahue,91,56,147,0.6190476190476191,46
Kahuhu,21,19,40,0.525,46
Kaʻaeʻa,27,15,42,0.6428571428571429,46
Kaʻahanui,32,23,55,0.5818181818181818,46
Kaʻai,39,23,62,0.6290322580645161,46
Kaʻaihue,38,23,61,0.6229508196721312,46
Kaʻākau,35,34,69,0.5072463768115942,46
Kaʻanāʻanā,84,57,141,0.5957446808510638,46
Kaʻaua/Kaʻauʻa,49,49,98,0.5,46
Kaʻaukai,38,32,70,0.5428571428571428,46
Kaʻawa,33,20,53,0.6226415094339622,46
Kaʻili,52,42,94,0.5531914893617021,46
Kaʻilianu,35,16,51,0.6862745098039216,46
Kaiʻa,45,32,77,0.5844155844155844,46
Kaina,29,18,47,0.6170212765957447,46
Kaipo,29,13,42,0.6904761904761905,46
Kaiwi,55,42,97,0.5670103092783505,46
Kalā/Kala,28,21,49,0.5714285714285714,46
Kalama,74,54,128,0.578125,46
Kalawaiʻa,63,36,99,0.6363636363636364,46
Kalehua,27,15,42,0.6428571428571429,46
Kalei,19,21,40,0.475,46
Kaleo,25,18,43,0.5813953488372093,46
Kalili,41,35,76,0.5394736842105263,46
Kalua,190,137,327,0.581039755351682,46
Ahia,17,26,43,0.3953488372093023,47
Alapaʻi,28,24,52,0.5384615384615384,47
Haʻaheo,23,14,37,0.6216216216216216,47
Hana,49,46,95,0.5157894736842106,47
Haole,21,25,46,0.45652173913043476,47
Hina,32,13,45,0.7111111111111111,47
ʻEhu,27,20,47,0.574468085106383,47
Kahananui,56,39,95,0.5894736842105263,47
Kaheana,46,35,81,0.5679012345679012,47
Kahele,74,59,133,0.556390977443609,47
Kahili/Kāhili,24,18,42,0.5714285714285714,47
Kahinu,42,11,53,0.7924528301886793,47
Kahue,92,55,147,0.6258503401360545,47
Kahuhu,19,21,40,0.475,47
Kaʻaeʻa,25,17,42,0.5952380952380952,47
Kaʻahanui,32,23,55,0.5818181818181818,47
Kaʻai,33,29,62,0.532258064516129,47
Kaʻaihue,31,30,61,0.5081967213114754,47
Kaʻākau,42,27,69,0.6086956521739131,47
Kaʻanāʻanā,82,59,141,0.5815602836879432,47
Kaʻaua/Kaʻauʻa,60,38,98,0.6122448979591837,47
Kaʻaukai,43,27,70,0.6142857142857143,47
Kaʻawa,24,29,53,0.4528301886792453,47
Kaʻili,60,34,94,0.6382978723404256,47
Kaʻilianu,29,22,51,0.5686274509803921,47
Kaiʻa,45,32,77,0.5844155844155844,47
Kaina,29,18,47,0.6170212765957447,47
Kaipo,22,20,42,0.5238095238095238,47
Kaiwi,55,42,97,0.5670103092783505,47
Kalā/Kala,27,22,49,0.5510204081632653,47
Kalama,79,49,128,0.6171875,47
Kalawaiʻa,59,40,99,0.5959595959595959,47
Kalehua,27,15,42,0.6428571428571429,47
Kalei,21,19,40,0.525,47
Kaleo,24,19,43,0.5581395348837209,47
Kalili,50,26,76,0.6578947368421053,47
Kalua,185,142,327,0.5657492354740061,47
Ahia,18,25,43,0.4186046511627907,48
Alapaʻi,36,16,52,0.6923076923076923,48
Haʻaheo,22,15,37,0.5945945945945946,48
Hana,68,27,95,0.7157894736842105,48
Haole,28,18,46,0.6086956521739131,48
Hina,28,17,45,0.6222222222222222,48
ʻEhu,23,24,47,0.48936170212765956,48
Kahananui,48,47,95,0.5052631578947369,48
Kaheana,45,36,81,0.5555555555555556,48
Kahele,71,62,133,0.5338345864661654,48
Kahili/Kāhili,20,22,42,0.47619047619047616,48
Kahinu,34,19,53,0.6415094339622641,48
Kahue,87,60,147,0.5918367346938775,48
Kahuhu,25,15,40,0.625,48
Kaʻaeʻa,20,22,42,0.47619047619047616,48
Kaʻahanui,33,22,55,0.6,48
Kaʻai,30,32,62,0.4838709677419355,48
Kaʻaihue,38,23,61,0.6229508196721312,48
Kaʻākau,40,29,69,0.5797101449275363,48
Kaʻanāʻanā,89,52,141,0.6312056737588653,48
Kaʻaua/Kaʻauʻa,50,48,98,0.5102040816326531,48
Kaʻaukai,37,33,70,0.5285714285714286,48
Kaʻawa,30,23,53,0.5660377358490566,48
Kaʻili,60,34,94,0.6382978723404256,48
Kaʻilianu,25,26,51,0.49019607843137253,48
Kaiʻa,43,34,77,0.5584415584415584,48
Kaina,32,15,47,0.6808510638297872,48
Kaipo,23,19,42,0.5476190476190477,48
Kaiwi,64,33,97,0.6597938144329897,48
Kalā/Kala,31,18,49,0.6326530612244898,48
Kalama,66,62,128,0.515625,48
Kalawaiʻa,57,42,99,0.5757575757575758,48
Kalehua,24,18,42,0.5714285714285714,48
Kalei,21,19,40,0.525,48
Kaleo,26,17,43,0.6046511627906976,48
Kalili,47,29,76,0.618421052631579,48
Kalua,195,132,327,0.5963302752293578,48
Ahia,25,18,43,0.5813953488372093,49
Alapaʻi,27,25,52,0.5192307692307693,49
Haʻaheo,25,12,37,0.6756756756756757,49
Hana,53,42,95,0.5578947368421052,49
Haole,26,20,46,0.5652173913043478,49
Hina,28,17,45,0.6222222222222222,49
ʻEhu,24,23,47,0.5106382978723404,49
Kahananui,65,30,95,0.6842105263157895,49
Kaheana,45,36,81,0.5555555555555556,49
Kahele,75,58,133,0.5639097744360902,49
Kahili/Kāhili,23,19,42,0.5476190476190477,49
Kahinu,33,20,53,0.6226415094339622,49
Kahue,90,57,147,0.6122448979591837,49
Kahuhu,23,17,40,0.575,49
Kaʻaeʻa,21,21,42,0.5,49
Kaʻahanui,31,24,55,0.5636363636363636,49
Kaʻai,36,26,62,0.5806451612903226,49
Kaʻaihue,39,22,61,0.639344262295082,49
Kaʻākau,38,31,69,0.5507246376811594,49
Kaʻanāʻanā,73,68,141,0.5177304964539007,49
Kaʻaua/Kaʻauʻa,55,43,98,0.5612244897959183,49
Kaʻaukai,40,30,70,0.5714285714285714,49
Kaʻawa,30,23,53,0.5660377358490566,49
Kaʻili,62,32,94,0.6595744680851063,49
Kaʻilianu,33,18,51,0.6470588235294118,49
Kaiʻa,49,28,77,0.6363636363636364,49
Kaina,32,15,47,0.6808510638297872,49
Kaipo,21,21,42,0.5,49
Kaiwi,59,38,97,0.6082474226804123,49
Kalā/Kala,27,22,49,0.5510204081632653,49
Kalama,76,52,128,0.59375,49
Kalawaiʻa,56,43,99,0.5656565656565656,49
Kalehua,24,18,42,0.5714285714285714,49
Kalei,18,22,40,0.45,49
Kaleo,23,20,43,0.5348837209302325,49
Kalili,38,38,76,0.5,49
Kalua,191,136,327,0.5840978593272171,49
Ahia,28,15,43,0.6511627906976745,50
Alapaʻi,28,24,52,0.5384615384615384,50
Haʻaheo,21,16,37,0.5675675675675675,50
Hana,58,37,95,0.6105263157894737,50
Haole,23,23,46,0.5,50
Hina,25,20,45,0.5555555555555556,50
ʻEhu,27,20,47,0.574468085106383,50
Kahananui,58,37,95,0.6105263157894737,50
Kaheana,50,31,81,0.6172839506172839,50
Kahele,82,51,133,0.6165413533834586,50
Kahili/Kāhili,29,13,42,0.6904761904761905,50
Kahinu,29,24,53,0.5471698113207547,50
Kahue,93,54,147,0.6326530612244898,50
Kahuhu,22,18,40,0.55,50
Kaʻaeʻa,25,17,42,0.5952380952380952,50
Kaʻahanui,31,24,55,0.5636363636363636,50
Kaʻai,42,20,62,0.6774193548387096,50
Kaʻaihue,39,22,61,0.639344262295082,50
Kaʻākau,33,36,69,0.4782608695652174,50
Kaʻanāʻanā,75,66,141,0.5319148936170213,50
Kaʻaua/Kaʻauʻa,56,42,98,0.5714285714285714,50
Kaʻaukai,36,34,70,0.5142857142857142,50
Kaʻawa,36,17,53,0.6792452830188679,50
Kaʻili,54,40,94,0.574468085106383,50
Kaʻilianu,36,15,51,0.7058823529411765,50
Kaiʻa,42,35,77,0.5454545454545454,50
Kaina,30,17,47,0.6382978723404256,50
Kaipo,27,15,42,0.6428571428571429,50
Kaiwi,57,40,97,0.5876288659793815,50
Kalā/Kala,26,23,49,0.5306122448979592,50
Kalama,71,57,128,0.5546875,50
Kalawaiʻa,50,49,99,0.5050505050505051,50
Kalehua,18,24,42,0.42857142857142855,50
Kalei,22,18,40,0.55,50
Kaleo,29,14,43,0.6744186046511628,50
Kalili,39,37,76,0.5131578947368421,50
Kalua,187,140,327,0.5718654434250765,50
Ahia,25,18,43,0.5813953488372093,51
Alapaʻi,32,20,52,0.6153846153846154,51
Haʻaheo,22,15,37,0.5945945945945946,51
Hana,48,47,95,0.5052631578947369,51
Haole,33,13,46,0.717391304347826,51
Hina,29,16,45,0.6444444444444445,51
ʻEhu,24,23,47,0.5106382978723404,51
Kahananui,50,45,95,0.5263157894736842,51
Kaheana,43,38,81,0.5308641975308642,51
Kahele,76,57,133,0.5714285714285714,51
Kahili/Kāhili,23,19,42,0.5476190476190477,51
Kahinu,27,26,53,0.5094339622641509,51
Kahue,86,61,147,0.5850340136054422,51
Kahuhu,26,14,40,0.65,51
Kaʻaeʻa,26,16,42,0.6190476190476191,51
Kaʻahanui,37,18,55,0.6727272727272727,51
Kaʻai,33,29,62,0.532258064516129,51
Kaʻaihue,35,26,61,0.5737704918032787,51
Kaʻākau,45,24,69,0.6521739130434783,51
Kaʻanāʻanā,95,46,141,0.6737588652482269,51
Kaʻaua/Kaʻauʻa,51,47,98,0.5204081632653061,51
Kaʻaukai,43,27,70,0.6142857142857143,51
Kaʻawa,27,26,53,0.5094339622641509,51
Kaʻili,57,37,94,0.6063829787234043,51
Kaʻilianu,34,17,51,0.6666666666666666,51
Kaiʻa,48,29,77,0.6233766233766234,51
Kaina,25,22,47,0.5319148936170213,51
Kaipo,18,24,42,0.42857142857142855,51
Kaiwi,63,34,97,0.6494845360824743,51
Kalā/Kala,32,17,49,0.6530612244897959,51
Kalama,79,49,128,0.6171875,51
Kalawaiʻa,60,39,99,0.6060606060606061,51
Kalehua,20,22,42,0.47619047619047616,51
Kalei,25,15,40,0.625,51
Kaleo,22,21,43,0.5116279069767442,51
Kalili,41,35,76,0.5394736842105263,51
Kalua,174,153,327,0.5321100917431193,51
Ahia,27,16,43,0.627906976744186,52
Alapaʻi,25,27,52,0.4807692307692308,52
Haʻaheo,24,13,37,0.6486486486486487,52
Hana,57,38,95,0.6,52
Haole,30,16,46,0.6521739130434783,52
Hina,24,21,45,0.5333333333333333,52
ʻEhu,29,18,47,0.6170212765957447,52
Kahananui,51,44,95,0.5368421052631579,52
Kaheana,50,31,81,0.6172839506172839,52
Kahele,73,60,133,0.5488721804511278,52
Kahili/Kāhili,22,20,42,0.5238095238095238,52
Kahinu,31,22,53,0.5849056603773585,52
Kahue,77,70,147,0.5238095238095238,52
Kahuhu,24,16,40,0.6,52
Kaʻaeʻa,25,17,42,0.5952380952380952,52
Kaʻahanui,33,22,55,0.6,52
Kaʻai,38,24,62,0.6129032258064516,52
Kaʻaihue,34,27,61,0.5573770491803278,52
Kaʻākau,42,27,69,0.6086956521739131,52
Kaʻanāʻanā,90,51,141,0.6382978723404256,52
Kaʻaua/Kaʻauʻa,52,46,98,0.5306122448979592,52
Kaʻaukai,39,31,70,0.5571428571428572,52
Kaʻawa,36,17,53,0.6792452830188679,52
Kaʻili,60,34,94,0.6382978723404256,52
Kaʻilianu,29,22,51,0.5686274509803921,52
Kaiʻa,48,29,77,0.6233766233766234,52
Kaina,24,23,47,0.5106382978723404,52
Kaipo,22,20,42,0.5238095238095238,52
Kaiwi,54,43,97,0.5567010309278351,52
Kalā/Kala,30,19,49,0.6122448979591837,52
Kalama,67,61,128,0.5234375,52
Kalawaiʻa,61,38,99,0.6161616161616161,52
Kalehua,25,17,42,0.5952380952380952,52
Kalei,25,15,40,0.625,52
Kaleo,22,21,43,0.5116279069767442,52
Kalili,42,34,76,0.5526315789473685,52
Kalua,192,135,327,0.5871559633027523,52
Ahia,25,18,43,0.5813953488372093,53
Alapaʻi,29,23,52,0.5576923076923077,53
Haʻaheo,19,18,37,0.5135135135135135,53
Hana,67,28,95,0.7052631578947368,53
Haole,26,20,46,0.5652173913043478,53
Hina,27,18,45,0.6,53
ʻEhu,26,21,47,0.5531914893617021,53
Kahananui,57,38,95,0.6,53
Kaheana,45,36,81,0.5555555555555556,53
Kahele,78,55,133,0.5864661654135338,53
Kahili/Kāhili,26,16,42,0.6190476190476191,53
Kahinu,32,21,53,0.6037735849056604,53
Kahue,81,66,147,0.5510204081632653,53
Kahuhu,23,17,40,0.575,53
Kaʻaeʻa,25,17,42,0.5952380952380952,53
Kaʻahanui,29,26,55,0.5272727272727272,53
Kaʻai,35,27,62,0.5645161290322581,53
Kaʻaihue,29,32,61,0.47540983606557374,53
Kaʻākau,35,34,69,0.5072463768115942,53
Kaʻanāʻanā,93,48,141,0.6595744680851063,53
Kaʻaua/Kaʻauʻa,64,34,98,0.6530612244897959,53
Kaʻaukai,36,34,70,0.5142857142857142,53
Kaʻawa,37,16,53,0.6981132075471698,53
Kaʻili,54,40,94,0.574468085106383,53
Kaʻilianu,23,28,51,0.45098039215686275,53
Kaiʻa,40,37,77,0.5194805194805194,53
Kaina,21,26,47,0.44680851063829785,53
Kaipo,26,16,42,0.6190476190476191,53
Kaiwi,54,43,97,0.5567010309278351,53
Kalā/Kala,30,19,49,0.6122448979591837,53
Kalama,79,49,128,0.6171875,53
Kalawaiʻa,50,49,99,0.5050505050505051,53
Kalehua,27,15,42,0.6428571428571429,53
Kalei,23,17,40,0.575,53
Kaleo,24,19,43,0.5581395348837209,53
Kalili,38,38,76,0.5,53
Kalua,201,126,327,0.6146788990825688,53
Ahia,30,13,43,0.6976744186046512,54
Alapaʻi,27,25,52,0.5192307692307693,54
Haʻaheo,15,22,37,0.40540540540540543,54
Hana,50,45,95,0.5263157894736842,54
Haole,30,16,46,0.6521739130434783,54
Hina,26,19,45,0.5777777777777777,54
ʻEhu,30,17,47,0.6382978723404256,54
Kahananui,55,40,95,0.5789473684210527,54
Kaheana,56,25,81,0.691358024691358,54
Kahele,79,54,133,0.5939849624060151,54
Kahili/Kāhili,24,18,42,0.5714285714285714,54
Kahinu,28,25,53,0.5283018867924528,54
Kahue,89,58,147,0.6054421768707483,54
Kahuhu,19,21,40,0.475,54
Kaʻaeʻa,22,20,42,0.5238095238095238,54
Kaʻahanui,34,21,55,0.6181818181818182,54
Kaʻai,42,20,62,0.6774193548387096,54
Kaʻaihue,35,26,61,0.5737704918032787,54
Kaʻākau,30,39,69,0.43478260869565216,54
Kaʻanāʻanā,92,49,141,0.6524822695035462,54
Kaʻaua/Kaʻauʻa,55,43,98,0.5612244897959183,54
Kaʻaukai,42,28,70,0.6,54
Kaʻawa,26,27,53,0.49056603773584906,54
Kaʻili,55,39,94,0.5851063829787234,54
Kaʻilianu,33,18,51,0.6470588235294118,54
Kaiʻa,44,33,77,0.5714285714285714,54
Kaina,30,17,47,0.6382978723404256,54
Kaipo,29,13,42,0.6904761904761905,54
Kaiwi,60,37,97,0.6185567010309279,54
Kalā/Kala,26,23,49,0.5306122448979592,54
Kalama,71,57,128,0.5546875,54
Kalawaiʻa,49,50,99,0.494949494949495,54
Kalehua,21,21,42,0.5,54
Kalei,24,16,40,0.6,54
Kaleo,30,13,43,0.6976744186046512,54
Kalili,44,32,76,0.5789473684210527,54
Kalua,182,145,327,0.5565749235474006,54
Ahia,22,21,43,0.5116279069767442,55
Alapaʻi,32,20,52,0.6153846153846154,55
Haʻaheo,23,14,37,0.6216216216216216,55
Hana,62,33,95,0.6526315789473685,55
Haole,25,21,46,0.5434782608695652,55
Hina,24,21,45,0.5333333333333333,55
ʻEhu,23,24,47,0.48936170212765956,55
Kahananui,47,48,95,0.49473684210526314,55
Kaheana,42,39,81,0.5185185185185185,55
Kahele,82,51,133,0.6165413533834586,55
Kahili/Kāhili,27,15,42,0.6428571428571429,55
Kahinu,35,18,53,0.660377358490566,55
Kahue,96,51,147,0.6530612244897959,55
Kahuhu,24,16,40,0.6,55
Kaʻaeʻa,24,18,42,0.5714285714285714,55
Kaʻahanui,32,23,55,0.5818181818181818,55
Kaʻai,39,23,62,0.6290322580645161,55
Kaʻaihue,42,19,61,0.6885245901639344,55
Kaʻākau,47,22,69,0.6811594202898551,55
Kaʻanāʻanā,89,52,141,0.6312056737588653,55
Kaʻaua/Kaʻauʻa,53,45,98,0.5408163265306123,55
Kaʻaukai,37,33,70,0.5285714285714286,55
Kaʻawa,27,26,53,0.5094339622641509,55
Kaʻili,52,42,94,0.5531914893617021,55
Kaʻilianu,29,22,51,0.5686274509803921,55
Kaiʻa,40,37,77,0.5194805194805194,55
Kaina,28,19,47,0.5957446808510638,55
Kaipo,25,17,42,0.5952380952380952,55
Kaiwi,53,44,97,0.5463917525773195,55
Kalā/Kala,25,24,49,0.5102040816326531,55
Kalama,70,58,128,0.546875,55
Kalawaiʻa,58,41,99,0.5858585858585859,55
Kalehua,27,15,42,0.6428571428571429,55
Kalei,24,16,40,0.6,55
Kaleo,23,20,43,0.5348837209302325,55
Kalili,44,32,76,0.5789473684210527,55
Kalua,182,145,327,0.5565749235474006,55
Ahia,31,12,43,0.7209302325581395,56
Alapaʻi,31,21,52,0.5961538461538461,56
Haʻaheo,23,14,37,0.6216216216216216,56
Hana,61,34,95,0.6421052631578947,56
Haole,24,22,46,0.5217391304347826,56
Hina,27,18,45,0.6,56
ʻEhu,29,18,47,0.6170212765957447,56
Kahananui,50,45,95,0.5263157894736842,56
Kaheana,44,37,81,0.5432098765432098,56
Kahele,72,61,133,0.5413533834586466,56
Kahili/Kāhili,23,19,42,0.5476190476190477,56
Kahinu,29,24,53,0.5471698113207547,56
Kahue,85,62,147,0.5782312925170068,56
Kahuhu,25,15,40,0.625,56
Kaʻaeʻa,27,15,42,0.6428571428571429,56
Kaʻahanui,34,21,55,0.6181818181818182,56
Kaʻai,36,26,62,0.5806451612903226,56
Kaʻaihue,36,25,61,0.5901639344262295,56
Kaʻākau,41,28,69,0.5942028985507246,56
Kaʻanāʻanā,86,55,141,0.6099290780141844,56
Kaʻaua/Kaʻauʻa,51,47,98,0.5204081632653061,56
Kaʻaukai,42,28,70,0.6,56
Kaʻawa,29,24,53,0.5471698113207547,56
Kaʻili,58,36,94,0.6170212765957447,56
Kaʻilianu,30,21,51,0.5882352941176471,56
Kaiʻa,36,41,77,0.4675324675324675,56
Kaina,28,19,47,0.5957446808510638,56
Kaipo,25,17,42,0.5952380952380952,56
Kaiwi,59,38,97,0.6082474226804123,56
Kalā/Kala,37,12,49,0.7551020408163265,56
Kalama,66,62,128,0.515625,56
Kalawaiʻa,54,45,99,0.5454545454545454,56
Kalehua,26,16,42,0.6190476190476191,56
Kalei,28,12,40,0.7,56
Kaleo,22,21,43,0.5116279069767442,56
Kalili,36,40,76,0.47368421052631576,56
Kalua,193,134,327,0.5902140672782875,56
Ahia,24,19,43,0.5581395348837209,57
Alapaʻi,30,22,52,0.5769230769230769,57
Haʻaheo,21,16,37,0.5675675675675675,57
Hana,53,42,95,0.5578947368421052,57
Haole,20,26,46,0.43478260869565216,57
Hina,28,17,45,0.6222222222222222,57
ʻEhu,31,16,47,0.6595744680851063,57
Kahananui,51,44,95,0.5368421052631579,57
Kaheana,45,36,81,0.5555555555555556,57
Kahele,81,52,133,0.6090225563909775,57
Kahili/Kāhili,26,16,42,0.6190476190476191,57
Kahinu,30,23,53,0.5660377358490566,57
Kahue,89,58,147,0.6054421768707483,57
Kahuhu,22,18,40,0.55,57
Kaʻaeʻa,24,18,42,0.5714285714285714,57
Kaʻahanui,35,20,55,0.6363636363636364,57
Kaʻai,32,30,62,0.5161290322580645,57
Kaʻaihue,37,24,61,0.6065573770491803,57
Kaʻākau,46,23,69,0.6666666666666666,57
Kaʻanāʻanā,91,50,141,0.6453900709219859,57
Kaʻaua/Kaʻauʻa,58,40,98,0.5918367346938775,57
Kaʻaukai,39,31,70,0.5571428571428572,57
Kaʻawa,34,19,53,0.6415094339622641,57
Kaʻili,47,47,94,0.5,57
Kaʻilianu,35,16,51,0.6862745098039216,57
Kaiʻa,49,28,77,0.6363636363636364,57
Kaina,30,17,47,0.6382978723404256,57
Kaipo,24,18,42,0.5714285714285714,57
Kaiwi,56,41,97,0.5773195876288659,57
Kalā/Kala,34,15,49,0.6938775510204082,57
Kalama,70,58,128,0.546875,57
Kalawaiʻa,57,42,99,0.5757575757575758,57
Kalehua,23,19,42,0.5476190476190477,57
Kalei,24,16,40,0.6,57
Kaleo,24,19,43,0.5581395348837209,57
Kalili,37,39,76,0.4868421052631579,57
Kalua,177,150,327,0.5412844036697247,57
Ahia,23,20,43,0.5348837209302325,58
Alapaʻi,31,21,52,0.5961538461538461,58
Haʻaheo,25,12,37,0.6756756756756757,58
Hana,59,36,95,0.6210526315789474,58
Haole,25,21,46,0.5434782608695652,58
Hina,29,16,45,0.6444444444444445,58
ʻEhu,27,20,47,0.574468085106383,58
Kahananui,57,38,95,0.6,58
Kaheana,46,35,81,0.5679012345679012,58
Kahele,74,59,133,0.556390977443609,58
Kahili/Kāhili,24,18,42,0.5714285714285714,58
Kahinu,30,23,53,0.5660377358490566,58
Kahue,76,71,147,0.5170068027210885,58
Kahuhu,22,18,40,0.55,58
Kaʻaeʻa,17,25,42,0.40476190476190477,58
Kaʻahanui,34,21,55,0.6181818181818182,58
Kaʻai,36,26,62,0.5806451612903226,58
Kaʻaihue,35,26,61,0.5737704918032787,58
Kaʻākau,32,37,69,0.463768115942029,58
Kaʻanāʻanā,78,63,141,0.5531914893617021,58
Kaʻaua/Kaʻauʻa,51,47,98,0.5204081632653061,58
Kaʻaukai,46,24,70,0.6571428571428571,58
Kaʻawa,35,18,53,0.660377358490566,58
Kaʻili,57,37,94,0.6063829787234043,58
Kaʻilianu,24,27,51,0.47058823529411764,58
Kaiʻa,51,26,77,0.6623376623376623,58
Kaina,28,19,47,0.5957446808510638,58
Kaipo,25,17,42,0.5952380952380952,58
Kaiwi,61,36,97,0.6288659793814433,58
Kalā/Kala,26,23,49,0.5306122448979592,58
Kalama,79,49,128,0.6171875,58
Kalawaiʻa,63,36,99,0.6363636363636364,58
Kalehua,23,19,42,0.5476190476190477,58
Kalei,24,16,40,0.6,58
Kaleo,27,16,43,0.627906976744186,58
Kalili,40,36,76,0.5263157894736842,58
Kalua,194,133,327,0.5932721712538226,58
Ahia,21,22,43,0.4883720930232558,59
Alapaʻi,29,23,52,0.5576923076923077,59
Haʻaheo,25,12,37,0.6756756756756757,59
Hana,62,33,95,0.6526315789473685,59
Haole,25,21,46,0.5434782608695652,59
Hina,29,16,45,0.6444444444444445,59
ʻEhu,26,21,47,0.5531914893617021,59
Kahananui,57,38,95,0.6,59
Kaheana,42,39,81,0.5185185185185185,59
Kahele,71,62,133,0.5338345864661654,59
Kahili/Kāhili,21,21,42,0.5,59
Kahinu,30,23,53,0.5660377358490566,59
Kahue,88,59,147,0.5986394557823129,59
Kahuhu,20,20,40,0.5,59
Kaʻaeʻa,21,21,42,0.5,59
Kaʻahanui,32,23,55,0.5818181818181818,59
Kaʻai,34,28,62,0.5483870967741935,59
Kaʻaihue,34,27,61,0.5573770491803278,59
Kaʻākau,39,30,69,0.5652173913043478,59
Kaʻanāʻanā,86,55,141,0.6099290780141844,59
Kaʻaua/Kaʻauʻa,65,33,98,0.6632653061224489,59
Kaʻaukai,41,29,70,0.5857142857142857,59
Kaʻawa,34,19,53,0.6415094339622641,59
Kaʻili,54,40,94,0.574468085106383,59
Kaʻilianu,24,27,51,0.47058823529411764,59
Kaiʻa,44,33,77,0.5714285714285714,59
Kaina,19,28,47,0.40425531914893614,59
Kaipo,26,16,42,0.6190476190476191,59
Kaiwi,55,42,97,0.5670103092783505,59
Kalā/Kala,32,17,49,0.6530612244897959,59
Kalama,79,49,128,0.6171875,59
Kalawaiʻa,54,45,99,0.5454545454545454,59
Kalehua,23,19,42,0.5476190476190477,59
Kalei,21,19,40,0.525,59
Kaleo,24,19,43,0.5581395348837209,59
Kalili,51,25,76,0.6710526315789473,59
Kalua,196,131,327,0.599388379204893,59
Ahia,21,22,43,0.4883720930232558,60
Alapaʻi,26,26,52,0.5,60
Haʻaheo,19,18,37,0.5135135135135135,60
Hana,51,44,95,0.5368421052631579,60
Haole,23,23,46,0.5,60
Hina,32,13,45,0.7111111111111111,60
ʻEhu,35,12,47,0.7446808510638298,60
Kahananui,61,34,95,0.6421052631578947,60
Kaheana,44,37,81,0.5432098765432098,60
Kahele,77,56,133,0.5789473684210527,60
Kahili/Kāhili,25,17,42,0.5952380952380952,60
Kahinu,36,17,53,0.6792452830188679,60
Kahue,93,54,147,0.6326530612244898,60
Kahuhu,24,16,40,0.6,60
Kaʻaeʻa,28,14,42,0.6666666666666666,60
Kaʻahanui,28,27,55,0.509090909090909,60
Kaʻai,43,19,62,0.6935483870967742,60
Kaʻaihue,30,31,61,0.4918032786885246,60
Kaʻākau,35,34,69,0.5072463768115942,60
Kaʻanāʻanā,75,66,141,0.5319148936170213,60
Kaʻaua/Kaʻauʻa,52,46,98,0.5306122448979592,60
Kaʻaukai,45,25,70,0.6428571428571429,60
Kaʻawa,30,23,53,0.5660377358490566,60
Kaʻili,51,43,94,0.5425531914893617,60
Kaʻilianu,30,21,51,0.5882352941176471,60
Kaiʻa,47,30,77,0.6103896103896104,60
Kaina,30,17,47,0.6382978723404256,60
Kaipo,23,19,42,0.5476190476190477,60
Kaiwi,61,36,97,0.6288659793814433,60
Kalā/Kala,27,22,49,0.5510204081632653,60
Kalama,83,45,128,0.6484375,60
Kalawaiʻa,57,42,99,0.5757575757575758,60
Kalehua,27,15,42,0.6428571428571429,60
Kalei,20,20,40,0.5,60
Kaleo,28,15,43,0.6511627906976745,60
Kalili,40,36,76,0.5263157894736842,60
Kalua,177,150,327,0.5412844036697247,60
Ahia,14,29,43,0.32558139534883723,61
Alapaʻi,27,25,52,0.5192307692307693,61
Haʻaheo,21,16,37,0.5675675675675675,61
Hana,54,41,95,0.5684210526315789,61
Haole,28,18,46,0.6086956521739131,61
Hina,22,23,45,0.4888888888888889,61
ʻEhu,28,19,47,0.5957446808510638,61
Kahananui,63,32,95,0.6631578947368421,61
Kaheana,42,39,81,0.5185185185185185,61
Kahele,68,65,133,0.5112781954887218,61
Kahili/Kāhili,23,19,42,0.5476190476190477,61
Kahinu,37,16,53,0.6981132075471698,61
Kahue,93,54,147,0.6326530612244898,61
Kahuhu,24,16,40,0.6,61
Kaʻaeʻa,28,14,42,0.6666666666666666,61
Kaʻahanui,36,19,55,0.6545454545454545,61
Kaʻai,35,27,62,0.5645161290322581,61
Kaʻaihue,34,27,61,0.5573770491803278,61
Kaʻākau,42,27,69,0.6086956521739131,61
Kaʻanāʻanā,83,58,141,0.5886524822695035,61
Kaʻaua/Kaʻauʻa,58,40,98,0.5918367346938775,61
Kaʻaukai,40,30,70,0.5714285714285714,61
Kaʻawa,32,21,53,0.6037735849056604,61
Kaʻili,54,40,94,0.574468085106383,61
Kaʻilianu,28,23,51,0.5490196078431373,61
Kaiʻa,45,32,77,0.5844155844155844,61
Kaina,27,20,47,0.574468085106383,61
Kaipo,25,17,42,0.5952380952380952,61
Kaiwi,64,33,97,0.6597938144329897,61
Kalā/Kala,27,22,49,0.5510204081632653,61
Kalama,73,55,128,0.5703125,61
Kalawaiʻa,49,50,99,0.494949494949495,61
Kalehua,22,20,42,0.5238095238095238,61
Kalei,26,14,40,0.65,61
Kaleo,24,19,43,0.5581395348837209,61
Kalili,48,28,76,0.631578947368421,61
Kalua,190,137,327,0.581039755351682,61
Ahia,32,11,43,0.7441860465116279,62
Alapaʻi,26,26,52,0.5,62
Haʻaheo,18,19,37,0.4864864864864865,62
Hana,54,41,95,0.5684210526315789,62
Haole,30,16,46,0.6521739130434783,62
Hina,24,21,45,0.5333333333333333,62
ʻEhu,31,16,47,0.6595744680851063,62
Kahananui,57,38,95,0.6,62
Kaheana,43,38,81,0.5308641975308642,62
Kahele,77,56,133,0.5789473684210527,62
Kahili/Kāhili,20,22,42,0.47619047619047616,62
Kahinu,26,27,53,0.49056603773584906,62
Kahue,77,70,147,0.5238095238095238,62
Kahuhu,24,16,40,0.6,62
Kaʻaeʻa,26,16,42,0.6190476190476191,62
Kaʻahanui,40,15,55,0.7272727272727273,62
Kaʻai,33,29,62,0.532258064516129,62
Kaʻaihue,24,37,61,0.39344262295081966,62
Kaʻākau,43,26,69,0.6231884057971014,62
Kaʻanāʻanā,79,62,141,0.5602836879432624,62
Kaʻaua/Kaʻauʻa,62,36,98,0.6326530612244898,62
Kaʻaukai,45,25,70,0.6428571428571429,62
Kaʻawa,27,26,53,0.5094339622641509,62
Kaʻili,50,44,94,0.5319148936170213,62
Kaʻilianu,33,18,51,0.6470588235294118,62
Kaiʻa,45,32,77,0.5844155844155844,62
Kaina,33,14,47,0.7021276595744681,62
Kaipo,20,22,42,0.47619047619047616,62
Kaiwi,58,39,97,0.5979381443298969,62
Kalā/Kala,30,19,49,0.6122448979591837,62
Kalama,79,49,128,0.6171875,62
Kalawaiʻa,64,35,99,0.6464646464646465,62
Kalehua,23,19,42,0.5476190476190477,62
Kalei,23,17,40,0.575,62
Kaleo,23,20,43,0.5348837209302325,62
Kalili,46,30,76,0.6052631578947368,62
Kalua,189,138,327,0.5779816513761468,62
Ahia,25,18,43,0.5813953488372093,63
Alapaʻi,29,23,52,0.5576923076923077,63
Haʻaheo,20,17,37,0.5405405405405406,63
Hana,54,41,95,0.5684210526315789,63
Haole,22,24,46,0.4782608695652174,63
Hina,25,20,45,0.5555555555555556,63
ʻEhu,29,18,47,0.6170212765957447,63
Kahananui,53,42,95,0.5578947368421052,63
Kaheana,42,39,81,0.5185185185185185,63
Kahele,73,60,133,0.5488721804511278,63
Kahili/Kāhili,27,15,42,0.6428571428571429,63
Kahinu,31,22,53,0.5849056603773585,63
Kahue,81,66,147,0.5510204081632653,63
Kahuhu,29,11,40,0.725,63
Kaʻaeʻa,27,15,42,0.6428571428571429,63
Kaʻahanui,33,22,55,0.6,63
Kaʻai,34,28,62,0.5483870967741935,63
Kaʻaihue,43,18,61,0.7049180327868853,63
Kaʻākau,41,28,69,0.5942028985507246,63
Kaʻanāʻanā,84,57,141,0.5957446808510638,63
Kaʻaua/Kaʻauʻa,58,40,98,0.5918367346938775,63
Kaʻaukai,39,31,70,0.5571428571428572,63
Kaʻawa,38,15,53,0.71698113207547165,63
Kaʻili,54,40,94,0.574468085106383,63
Kaʻilianu,33,18,51,0.6470588235294118,63
Kaiʻa,42,35,77,0.5454545454545454,63
Kaina,26,21,47,0.5531914893617021,63
Kaipo,29,13,42,0.6904761904761905,63
Kaiwi,53,44,97,0.5463917525773195,63
Kalā/Kala,27,22,49,0.5510204081632653,63
Kalama,79,49,128,0.6171875,63
Kalawaiʻa,48,51,99,0.48484848484848486,63
Kalehua,22,20,42,0.5238095238095238,63
Kalei,24,16,40,0.6,63
Kaleo,30,13,43,0.6976744186046512,63
Kalili,44,32,76,0.5789473684210527,63
Kalua,186,141,327,0.5688073394495413,63
Ahia,22,21,43,0.5116279069767442,64
Alapaʻi,32,20,52,0.6153846153846154,64
Haʻaheo,24,13,37,0.6486486486486487,64
Hana,55,40,95,0.5789473684210527,64
Haole,24,22,46,0.5217391304347826,64
Hina,28,17,45,0.6222222222222222,64
ʻEhu,29,18,47,0.6170212765957447,64
Kahananui,53,42,95,0.5578947368421052,64
Kaheana,53,28,81,0.654320987654321,64
Kahele,86,47,133,0.6466165413533834,64
Kahili/Kāhili,24,18,42,0.5714285714285714,64
Kahinu,31,22,53,0.5849056603773585,64
Kahue,83,64,147,0.564625850340136,64
Kahuhu,22,18,40,0.55,64
Kaʻaeʻa,22,20,42,0.5238095238095238,64
Kaʻahanui,36,19,55,0.6545454545454545,64
Kaʻai,34,28,62,0.5483870967741935,64
Kaʻaihue,33,28,61,0.5409836065573771,64
Kaʻākau,37,32,69,0.5362318840579711,64
Kaʻanāʻanā,74,67,141,0.524822695035461,64
Kaʻaua/Kaʻauʻa,62,36,98,0.6326530612244898,64
Kaʻaukai,35,35,70,0.5,64
Kaʻawa,32,21,53,0.6037735849056604,64
Kaʻili,50,44,94,0.5319148936170213,64
Kaʻilianu,24,27,51,0.47058823529411764,64
Kaiʻa,45,32,77,0.5844155844155844,64
Kaina,27,20,47,0.574468085106383,64
Kaipo,24,18,42,0.5714285714285714,64
Kaiwi,58,39,97,0.5979381443298969,64
Kalā/Kala,28,21,49,0.5714285714285714,64
Kalama,70,58,128,0.546875,64
Kalawaiʻa,60,39,99,0.6060606060606061,64
Kalehua,23,19,42,0.5476190476190477,64
Kalei,18,22,40,0.45,64
Kaleo,31,12,43,0.7209302325581395,64
Kalili,49,27,76,0.6447368421052632,64
Kalua,196,131,327,0.599388379204893,64
Ahia,19,24,43,0.4418604651162791,65
Alapaʻi,33,19,52,0.6346153846153846,65
Haʻaheo,19,18,37,0.5135135135135135,65
Hana,58,37,95,0.6105263157894737,65
Haole,24,22,46,0.5217391304347826,65
Hina,21,24,45,0.4666666666666667,65
ʻEhu,25,22,47,0.5319148936170213,65
Kahananui,49,46,95,0.5157894736842106,65
Kaheana,48,33,81,0.5925925925925926,65
Kahele,88,45,133,0.6616541353383458,65
Kahili/Kāhili,20,22,42,0.47619047619047616,65
Kahinu,29,24,53,0.5471698113207547,65
Kahue,82,65,147,0.5578231292517006,65
Kahuhu,29,11,40,0.725,65
Kaʻaeʻa,25,17,42,0.5952380952380952,65
Kaʻahanui,32,23,55,0.5818181818181818,65
Kaʻai,43,19,62,0.6935483870967742,65
Kaʻaihue,37,24,61,0.6065573770491803,65
Kaʻākau,43,26,69,0.6231884057971014,65
Kaʻanāʻanā,77,64,141,0.5460992907801419,65
Kaʻaua/Kaʻauʻa,58,40,98,0.5918367346938775,65
Kaʻaukai,49,21,70,0.7,65
Kaʻawa,33,20,53,0.6226415094339622,65
Kaʻili,53,41,94,0.5638297872340425,65
Kaʻilianu,35,16,51,0.6862745098039216,65
Kaiʻa,36,41,77,0.4675324675324675,65
Kaina,31,16,47,0.6595744680851063,65
Kaipo,28,14,42,0.6666666666666666,65
Kaiwi,49,48,97,0.5051546391752577,65
Kalā/Kala,28,21,49,0.5714285714285714,65
Kalama,73,55,128,0.5703125,65
Kalawaiʻa,63,36,99,0.6363636363636364,65
Kalehua,19,23,42,0.4523809523809524,65
Kalei,26,14,40,0.65,65
Kaleo,22,21,43,0.5116279069767442,65
Kalili,38,38,76,0.5,65
Kalua,192,135,327,0.5871559633027523,65
Ahia,24,19,43,0.5581395348837209,66
Alapaʻi,22,30,52,0.4230769230769231,66
Haʻaheo,23,14,37,0.6216216216216216,66
Hana,55,40,95,0.5789473684210527,66
Haole,26,20,46,0.5652173913043478,66
Hina,30,15,45,0.6666666666666666,66
ʻEhu,23,24,47,0.48936170212765956,66
Kahananui,53,42,95,0.5578947368421052,66
Kaheana,45,36,81,0.5555555555555556,66
Kahele,91,42,133,0.6842105263157895,66
Kahili/Kāhili,31,11,42,0.7380952380952381,66
Kahinu,30,23,53,0.5660377358490566,66
Kahue,82,65,147,0.5578231292517006,66
Kahuhu,20,20,40,0.5,66
Kaʻaeʻa,29,13,42,0.6904761904761905,66
Kaʻahanui,34,21,55,0.6181818181818182,66
Kaʻai,41,21,62,0.6612903225806451,66
Kaʻaihue,36,25,61,0.5901639344262295,66
Kaʻākau,44,25,69,0.6376811594202898,66
Kaʻanāʻanā,78,63,141,0.5531914893617021,66
Kaʻaua/Kaʻauʻa,72,26,98,0.7346938775510204,66
Kaʻaukai,40,30,70,0.5714285714285714,66
Kaʻawa,32,21,53,0.6037735849056604,66
Kaʻili,49,45,94,0.5212765957446809,66
Kaʻilianu,30,21,51,0.5882352941176471,66
Kaiʻa,46,31,77,0.5974025974025974,66
Kaina,29,18,47,0.6170212765957447,66
Kaipo,24,18,42,0.5714285714285714,66
Kaiwi,58,39,97,0.5979381443298969,66
Kalā/Kala,28,21,49,0.5714285714285714,66
Kalama,64,64,128,0.5,66
Kalawaiʻa,61,38,99,0.6161616161616161,66
Kalehua,23,19,42,0.5476190476190477,66
Kalei,24,16,40,0.6,66
Kaleo,23,20,43,0.5348837209302325,66
Kalili,40,36,76,0.5263157894736842,66
Kalua,174,153,327,0.5321100917431193,66
Ahia,25,18,43,0.5813953488372093,67
Alapaʻi,37,15,52,0.7115384615384616,67
Haʻaheo,16,21,37,0.43243243243243246,67
Hana,50,45,95,0.5263157894736842,67
Haole,27,19,46,0.5869565217391305,67
Hina,25,20,45,0.5555555555555556,67
ʻEhu,28,19,47,0.5957446808510638,67
Kahananui,52,43,95,0.5473684210526316,67
Kaheana,47,34,81,0.5802469135802469,67
Kahele,79,54,133,0.5939849624060151,67
Kahili/Kāhili,21,21,42,0.5,67
Kahinu,38,15,53,0.71698113207547165,67
Kahue,82,65,147,0.5578231292517006,67
Kahuhu,27,13,40,0.675,67
Kaʻaeʻa,27,15,42,0.6428571428571429,67
Kaʻahanui,32,23,55,0.5818181818181818,67
Kaʻai,34,28,62,0.5483870967741935,67
Kaʻaihue,40,21,61,0.6557377049180327,67
Kaʻākau,42,27,69,0.6086956521739131,67
Kaʻanāʻanā,78,63,141,0.5531914893617021,67
Kaʻaua/Kaʻauʻa,50,48,98,0.5102040816326531,67
Kaʻaukai,48,22,70,0.6857142857142857,67
Kaʻawa,33,20,53,0.6226415094339622,67
Kaʻili,57,37,94,0.6063829787234043,67
Kaʻilianu,34,17,51,0.6666666666666666,67
Kaiʻa,41,36,77,0.5324675324675324,67
Kaina,29,18,47,0.6170212765957447,67
Kaipo,24,18,42,0.5714285714285714,67
Kaiwi,53,44,97,0.5463917525773195,67
Kalā/Kala,26,23,49,0.5306122448979592,67
Kalama,72,56,128,0.5625,67
Kalawaiʻa,54,45,99,0.5454545454545454,67
Kalehua,26,16,42,0.6190476190476191,67
Kalei,20,20,40,0.5,67
Kaleo,27,16,43,0.627906976744186,67
Kalili,44,32,76,0.5789473684210527,67
Kalua,189,138,327,0.5779816513761468,67
Ahia,29,14,43,0.6744186046511628,68
Alapaʻi,29,23,52,0.5576923076923077,68
Haʻaheo,20,17,37,0.5405405405405406,68
Hana,60,35,95,0.631578947368421,68
Haole,31,15,46,0.6739130434782609,68
Hina,26,19,45,0.5777777777777777,68
ʻEhu,28,19,47,0.5957446808510638,68
Kahananui,51,44,95,0.5368421052631579,68
Kaheana,52,29,81,0.6419753086419753,68
Kahele,68,65,133,0.5112781954887218,68
Kahili/Kāhili,24,18,42,0.5714285714285714,68
Kahinu,32,21,53,0.6037735849056604,68
Kahue,75,72,147,0.5102040816326531,68
Kahuhu,20,20,40,0.5,68
Kaʻaeʻa,29,13,42,0.6904761904761905,68
Kaʻahanui,34,21,55,0.6181818181818182,68
Kaʻai,34,28,62,0.5483870967741935,68
Kaʻaihue,39,22,61,0.639344262295082,68
Kaʻākau,40,29,69,0.5797101449275363,68
Kaʻanāʻanā,82,59,141,0.5815602836879432,68
Kaʻaua/Kaʻauʻa,55,43,98,0.5612244897959183,68
Kaʻaukai,41,29,70,0.5857142857142857,68
Kaʻawa,35,18,53,0.660377358490566,68
Kaʻili,60,34,94,0.6382978723404256,68
Kaʻilianu,25,26,51,0.49019607843137253,68
Kaiʻa,47,30,77,0.6103896103896104,68
Kaina,24,23,47,0.5106382978723404,68
Kaipo,27,15,42,0.6428571428571429,68
Kaiwi,54,43,97,0.5567010309278351,68
Kalā/Kala,31,18,49,0.6326530612244898,68
Kalama,73,55,128,0.5703125,68
Kalawaiʻa,59,40,99,0.5959595959595959,68
Kalehua,21,21,42,0.5,68
Kalei,26,14,40,0.65,68
Kaleo,24,19,43,0.5581395348837209,68
Kalili,42,34,76,0.5526315789473685,68
Kalua,187,140,327,0.5718654434250765,68
Ahia,28,15,43,0.6511627906976745,69
Alapaʻi,33,19,52,0.6346153846153846,69
Haʻaheo,18,19,37,0.4864864864864865,69
Hana,53,42,95,0.5578947368421052,69
Haole,27,19,46,0.5869565217391305,69
Hina,20,25,45,0.4444444444444444,69
ʻEhu,27,20,47,0.574468085106383,69
Kahananui,54,41,95,0.5684210526315789,69
Kaheana,56,25,81,0.691358024691358,69
Kahele,81,52,133,0.6090225563909775,69
Kahili/Kāhili,25,17,42,0.5952380952380952,69
Kahinu,25,28,53,0.4716981132075472,69
Kahue,85,62,147,0.5782312925170068,69
Kahuhu,21,19,40,0.525,69
Kaʻaeʻa,31,11,42,0.7380952380952381,69
Kaʻahanui,31,24,55,0.5636363636363636,69
Kaʻai,33,29,62,0.532258064516129,69
Kaʻaihue,33,28,61,0.5409836065573771,69
Kaʻākau,36,33,69,0.5217391304347826,69
Kaʻanāʻanā,87,54,141,0.6170212765957447,69
Kaʻaua/Kaʻauʻa,60,38,98,0.6122448979591837,69
Kaʻaukai,35,35,70,0.5,69
Kaʻawa,30,23,53,0.5660377358490566,69
Kaʻili,58,36,94,0.6170212765957447,69
Kaʻilianu,31,20,51,0.6078431372549019,69
Kaiʻa,39,38,77,0.5064935064935064,69
Kaina,24,23,47,0.5106382978723404,69
Kaipo,18,24,42,0.42857142857142855,69
Kaiwi,55,42,97,0.5670103092783505,69
Kalā/Kala,31,18,49,0.6326530612244898,69
Kalama,74,54,128,0.578125,69
Kalawaiʻa,59,40,99,0.5959595959595959,69
Kalehua,27,15,42,0.6428571428571429,69
Kalei,25,15,40,0.625,69
Kaleo,22,21,43,0.5116279069767442,69
Kalili,39,37,76,0.5131578947368421,69
Kalua,203,124,327,0.6207951070336392,69
Ahia,21,22,43,0.4883720930232558,70
Alapaʻi,34,18,52,0.6538461538461539,70
Haʻaheo,20,17,37,0.5405405405405406,70
Hana,57,38,95,0.6,70
Haole,28,18,46,0.6086956521739131,70
Hina,23,22,45,0.5111111111111111,70
ʻEhu,27,20,47,0.574468085106383,70
Kahananui,61,34,95,0.6421052631578947,70
Kaheana,52,29,81,0.6419753086419753,70
Kahele,79,54,133,0.5939849624060151,70
Kahili/Kāhili,26,16,42,0.6190476190476191,70
Kahinu,29,24,53,0.5471698113207547,70
Kahue,83,64,147,0.564625850340136,70
Kahuhu,19,21,40,0.475,70
Kaʻaeʻa,25,17,42,0.5952380952380952,70
Kaʻahanui,32,23,55,0.5818181818181818,70
Kaʻai,33,29,62,0.532258064516129,70
Kaʻaihue,31,30,61,0.5081967213114754,70
Kaʻākau,43,26,69,0.6231884057971014,70
Kaʻanāʻanā,80,61,141,0.5673758865248227,70
Kaʻaua/Kaʻauʻa,59,39,98,0.6020408163265306,70
Kaʻaukai,47,23,70,0.6714285714285714,70
Kaʻawa,30,23,53,0.5660377358490566,70
Kaʻili,57,37,94,0.6063829787234043,70
Kaʻilianu,26,25,51,0.5098039215686274,70
Kaiʻa,49,28,77,0.6363636363636364,70
Kaina,28,19,47,0.5957446808510638,70
Kaipo,21,21,42,0.5,70
Kaiwi,46,51,97,0.4742268041237113,70
Kalā/Kala,23,26,49,0.46938775510204084,70
Kalama,79,49,128,0.6171875,70
Kalawaiʻa,58,41,99,0.5858585858585859,70
Kalehua,24,18,42,0.5714285714285714,70
Kalei,20,20,40,0.5,70
Kaleo,18,25,43,0.4186046511627907,70
Kalili,52,24,76,0.6842105263157895,70
Kalua,194,133,327,0.5932721712538226,70
Ahia,25,18,43,0.5813953488372093,71
Alapaʻi,28,24,52,0.5384615384615384,71
Haʻaheo,19,18,37,0.5135135135135135,71
Hana,52,43,95,0.5473684210526316,71
Haole,29,17,46,0.6304347826086957,71
Hina,27,18,45,0.6,71
ʻEhu,31,16,47,0.6595744680851063,71
Kahananui,60,35,95,0.631578947368421,71
Kaheana,53,28,81,0.654320987654321,71
Kahele,74,59,133,0.556390977443609,71
Kahili/Kāhili,19,23,42,0.4523809523809524,71
Kahinu,34,19,53,0.6415094339622641,71
Kahue,87,60,147,0.5918367346938775,71
Kahuhu,24,16,40,0.6,71
Kaʻaeʻa,21,21,42,0.5,71
Kaʻahanui,34,21,55,0.6181818181818182,71
Kaʻai,40,22,62,0.6451612903225806,71
Kaʻaihue,37,24,61,0.6065573770491803,71
Kaʻākau,36,33,69,0.5217391304347826,71
Kaʻanāʻanā,77,64,141,0.5460992907801419,71
Kaʻaua/Kaʻauʻa,56,42,98,0.5714285714285714,71
Kaʻaukai,42,28,70,0.6,71
Kaʻawa,37,16,53,0.6981132075471698,71
Kaʻili,56,38,94,0.5957446808510638,71
Kaʻilianu,25,26,51,0.49019607843137253,71
Kaiʻa,35,42,77,0.45454545454545453,71
Kaina,25,22,47,0.5319148936170213,71
Kaipo,24,18,42,0.5714285714285714,71
Kaiwi,56,41,97,0.5773195876288659,71
Kalā/Kala,29,20,49,0.5918367346938775,71
Kalama,88,40,128,0.6875,71
Kalawaiʻa,49,50,99,0.494949494949495,71
Kalehua,20,22,42,0.47619047619047616,71
Kalei,21,19,40,0.525,71
Kaleo,24,19,43,0.5581395348837209,71
Kalili,50,26,76,0.6578947368421053,71
Kalua,190,137,327,0.581039755351682,71
Ahia,28,15,43,0.6511627906976745,72
Alapaʻi,27,25,52,0.5192307692307693,72
Haʻaheo,27,10,37,0.7297297297297297,72
Hana,59,36,95,0.6210526315789474,72
Haole,26,20,46,0.5652173913043478,72
Hina,25,20,45,0.5555555555555556,72
ʻEhu,27,20,47,0.574468085106383,72
Kahananui,51,44,95,0.5368421052631579,72
Kaheana,60,21,81,0.7407407407407407,72
Kahele,74,59,133,0.556390977443609,72
Kahili/Kāhili,26,16,42,0.6190476190476191,72
Kahinu,35,18,53,0.660377358490566,72
Kahue,89,58,147,0.6054421768707483,72
Kahuhu,24,16,40,0.6,72
Kaʻaeʻa,22,20,42,0.5238095238095238,72
Kaʻahanui,30,25,55,0.5454545454545454,72
Kaʻai,37,25,62,0.5967741935483871,72
Kaʻaihue,38,23,61,0.6229508196721312,72
Kaʻākau,46,23,69,0.6666666666666666,72
Kaʻanāʻanā,75,66,141,0.5319148936170213,72
Kaʻaua/Kaʻauʻa,49,49,98,0.5,72
Kaʻaukai,42,28,70,0.6,72
Kaʻawa,32,21,53,0.6037735849056604,72
Kaʻili,48,46,94,0.5106382978723404,72
Kaʻilianu,30,21,51,0.5882352941176471,72
Kaiʻa,45,32,77,0.5844155844155844,72
Kaina,22,25,47,0.46808510638297873,72
Kaipo,26,16,42,0.6190476190476191,72
Kaiwi,57,40,97,0.5876288659793815,72
Kalā/Kala,33,16,49,0.673469387755102,72
Kalama,69,59,128,0.5390625,72
Kalawaiʻa,55,44,99,0.5555555555555556,72
Kalehua,21,21,42,0.5,72
Kalei,17,23,40,0.425,72
Kaleo,22,21,43,0.5116279069767442,72
Kalili,47,29,76,0.618421052631579,72
Kalua,193,134,327,0.5902140672782875,72
Ahia,26,17,43,0.6046511627906976,73
Alapaʻi,35,17,52,0.6730769230769231,73
Haʻaheo,21,16,37,0.5675675675675675,73
Hana,47,48,95,0.49473684210526314,73
Haole,24,22,46,0.5217391304347826,73
Hina,22,23,45,0.4888888888888889,73
ʻEhu,26,21,47,0.5531914893617021,73
Kahananui,61,34,95,0.6421052631578947,73
Kaheana,48,33,81,0.5925925925925926,73
Kahele,76,57,133,0.5714285714285714,73
Kahili/Kāhili,17,25,42,0.40476190476190477,73
Kahinu,29,24,53,0.5471698113207547,73
Kahue,88,59,147,0.5986394557823129,73
Kahuhu,23,17,40,0.575,73
Kaʻaeʻa,28,14,42,0.6666666666666666,73
Kaʻahanui,29,26,55,0.5272727272727272,73
Kaʻai,33,29,62,0.532258064516129,73
Kaʻaihue,40,21,61,0.6557377049180327,73
Kaʻākau,39,30,69,0.5652173913043478,73
Kaʻanāʻanā,88,53,141,0.624113475177305,73
Kaʻaua/Kaʻauʻa,60,38,98,0.6122448979591837,73
Kaʻaukai,40,30,70,0.5714285714285714,73
Kaʻawa,32,21,53,0.6037735849056604,73
Kaʻili,58,36,94,0.6170212765957447,73
Kaʻilianu,29,22,51,0.5686274509803921,73
Kaiʻa,46,31,77,0.5974025974025974,73
Kaina,29,18,47,0.6170212765957447,73
Kaipo,26,16,42,0.6190476190476191,73
Kaiwi,52,45,97,0.5360824742268041,73
Kalā/Kala,31,18,49,0.6326530612244898,73
Kalama,77,51,128,0.6015625,73
Kalawaiʻa,59,40,99,0.5959595959595959,73
Kalehua,24,18,42,0.5714285714285714,73
Kalei,20,20,40,0.5,73
Kaleo,24,19,43,0.5581395348837209,73
Kalili,38,38,76,0.5,73
Kalua,189,138,327,0.5779816513761468,73
Ahia,29,14,43,0.6744186046511628,74
Alapaʻi,23,29,52,0.4423076923076923,74
Haʻaheo,23,14,37,0.6216216216216216,74
Hana,56,39,95,0.5894736842105263,74
Haole,20,26,46,0.43478260869565216,74
Hina,29,16,45,0.6444444444444445,74
ʻEhu,26,21,47,0.5531914893617021,74
Kahananui,60,35,95,0.631578947368421,74
Kaheana,50,31,81,0.6172839506172839,74
Kahele,74,59,133,0.556390977443609,74
Kahili/Kāhili,26,16,42,0.6190476190476191,74
Kahinu,26,27,53,0.49056603773584906,74
Kahue,89,58,147,0.6054421768707483,74
Kahuhu,25,15,40,0.625,74
Kaʻaeʻa,25,17,42,0.5952380952380952,74
Kaʻahanui,33,22,55,0.6,74
Kaʻai,34,28,62,0.5483870967741935,74
Kaʻaihue,31,30,61,0.5081967213114754,74
Kaʻākau,44,25,69,0.6376811594202898,74
Kaʻanāʻanā,83,58,141,0.5886524822695035,74
Kaʻaua/Kaʻauʻa,60,38,98,0.6122448979591837,74
Kaʻaukai,45,25,70,0.6428571428571429,74
Kaʻawa,32,21,53,0.6037735849056604,74
Kaʻili,54,40,94,0.574468085106383,74
Kaʻilianu,24,27,51,0.47058823529411764,74
Kaiʻa,45,32,77,0.5844155844155844,74
Kaina,29,18,47,0.6170212765957447,74
Kaipo,22,20,42,0.5238095238095238,74
Kaiwi,59,38,97,0.6082474226804123,74
Kalā/Kala,27,22,49,0.5510204081632653,74
Kalama,74,54,128,0.578125,74
Kalawaiʻa,51,48,99,0.5151515151515151,74
Kalehua,23,19,42,0.5476190476190477,74
Kalei,28,12,40,0.7,74
Kaleo,28,15,43,0.6511627906976745,74
Kalili,48,28,76,0.631578947368421,74
Kalua,179,148,327,0.5474006116207951,74
Ahia,24,19,43,0.5581395348837209,75
Alapaʻi,28,24,52,0.5384615384615384,75
Haʻaheo,23,14,37,0.6216216216216216,75
Hana,48,47,95,0.5052631578947369,75
Haole,28,18,46,0.6086956521739131,75
Hina,28,17,45,0.6222222222222222,75
ʻEhu,26,21,47,0.5531914893617021,75
Kahananui,56,39,95,0.5894736842105263,75
Kaheana,39,42,81,0.48148148148148145,75
Kahele,80,53,133,0.6015037593984962,75
Kahili/Kāhili,27,15,42,0.6428571428571429,75
Kahinu,30,23,53,0.5660377358490566,75
Kahue,91,56,147,0.6190476190476191,75
Kahuhu,23,17,40,0.575,75
Kaʻaeʻa,23,19,42,0.5476190476190477,75
Kaʻahanui,35,20,55,0.6363636363636364,75
Kaʻai,28,34,62,0.45161290322580644,75
Kaʻaihue,39,22,61,0.639344262295082,75
Kaʻākau,37,32,69,0.5362318840579711,75
Kaʻanāʻanā,85,56,141,0.6028368794326241,75
Kaʻaua/Kaʻauʻa,49,49,98,0.5,75
Kaʻaukai,38,32,70,0.5428571428571428,75
Kaʻawa,32,21,53,0.6037735849056604,75
Kaʻili,62,32,94,0.6595744680851063,75
Kaʻilianu,31,20,51,0.6078431372549019,75
Kaiʻa,49,28,77,0.6363636363636364,75
Kaina,27,20,47,0.574468085106383,75
Kaipo,29,13,42,0.6904761904761905,75
Kaiwi,48,49,97,0.4948453608247423,75
Kalā/Kala,30,19,49,0.6122448979591837,75
Kalama,78,50,128,0.609375,75
Kalawaiʻa,52,47,99,0.5252525252525253,75
Kalehua,27,15,42,0.6428571428571429,75
Kalei,30,10,40,0.75,75
Kaleo,25,18,43,0.5813953488372093,75
Kalili,40,36,76,0.5263157894736842,75
Kalua,189,138,327,0.5779816513761468,75
Ahia,24,19,43,0.5581395348837209,76
Alapaʻi,27,25,52,0.5192307692307693,76
Haʻaheo,23,14,37,0.6216216216216216,76
Hana,55,40,95,0.5789473684210527,76
Haole,25,21,46,0.5434782608695652,76
Hina,28,17,45,0.6222222222222222,76
ʻEhu,32,15,47,0.6808510638297872,76
Kahananui,54,41,95,0.5684210526315789,76
Kaheana,43,38,81,0.5308641975308642,76
Kahele,84,49,133,0.631578947368421,76
Kahili/Kāhili,22,20,42,0.5238095238095238,76
Kahinu,32,21,53,0.6037735849056604,76
Kahue,91,56,147,0.6190476190476191,76
Kahuhu,23,17,40,0.575,76
Kaʻaeʻa,28,14,42,0.6666666666666666,76
Kaʻahanui,29,26,55,0.5272727272727272,76
Kaʻai,33,29,62,0.532258064516129,76
Kaʻaihue,36,25,61,0.5901639344262295,76
Kaʻākau,36,33,69,0.5217391304347826,76
Kaʻanāʻanā,81,60,141,0.574468085106383,76
Kaʻaua/Kaʻauʻa,60,38,98,0.6122448979591837,76
Kaʻaukai,44,26,70,0.6285714285714286,76
Kaʻawa,30,23,53,0.5660377358490566,76
Kaʻili,62,32,94,0.6595744680851063,76
Kaʻilianu,24,27,51,0.47058823529411764,76
Kaiʻa,36,41,77,0.4675324675324675,76
Kaina,29,18,47,0.6170212765957447,76
Kaipo,25,17,42,0.5952380952380952,76
Kaiwi,55,42,97,0.5670103092783505,76
Kalā/Kala,26,23,49,0.5306122448979592,76
Kalama,71,57,128,0.5546875,76
Kalawaiʻa,60,39,99,0.6060606060606061,76
Kalehua,24,18,42,0.5714285714285714,76
Kalei,24,16,40,0.6,76
Kaleo,26,17,43,0.6046511627906976,76
Kalili,47,29,76,0.618421052631579,76
Kalua,185,142,327,0.5657492354740061,76
Ahia,22,21,43,0.5116279069767442,77
Alapaʻi,33,19,52,0.6346153846153846,77
Haʻaheo,19,18,37,0.5135135135135135,77
Hana,61,34,95,0.6421052631578947,77
Haole,22,24,46,0.4782608695652174,77
Hina,28,17,45,0.6222222222222222,77
ʻEhu,30,17,47,0.6382978723404256,77
Kahananui,57,38,95,0.6,77
Kaheana,55,26,81,0.6790123456790124,77
Kahele,76,57,133,0.5714285714285714,77
Kahili/Kāhili,17,25,42,0.40476190476190477,77
Kahinu,33,20,53,0.6226415094339622,77
Kahue,85,62,147,0.5782312925170068,77
Kahuhu,22,18,40,0.55,77
Kaʻaeʻa,24,18,42,0.5714285714285714,77
Kaʻahanui,31,24,55,0.5636363636363636,77
Kaʻai,36,26,62,0.5806451612903226,77
Kaʻaihue,35,26,61,0.5737704918032787,77
Kaʻākau,43,26,69,0.6231884057971014,77
Kaʻanāʻanā,80,61,141,0.5673758865248227,77
Kaʻaua/Kaʻauʻa,52,46,98,0.5306122448979592,77
Kaʻaukai,39,31,70,0.5571428571428572,77
Kaʻawa,34,19,53,0.6415094339622641,77
Kaʻili,54,40,94,0.574468085106383,77
Kaʻilianu,30,21,51,0.5882352941176471,77
Kaiʻa,46,31,77,0.5974025974025974,77
Kaina,29,18,47,0.6170212765957447,77
Kaipo,18,24,42,0.42857142857142855,77
Kaiwi,57,40,97,0.5876288659793815,77
Kalā/Kala,26,23,49,0.5306122448979592,77
Kalama,75,53,128,0.5859375,77
Kalawaiʻa,56,43,99,0.5656565656565656,77
Kalehua,27,15,42,0.6428571428571429,77
Kalei,23,17,40,0.575,77
Kaleo,22,21,43,0.5116279069767442,77
Kalili,44,32,76,0.5789473684210527,77
Kalua,193,134,327,0.5902140672782875,77
Ahia,29,14,43,0.6744186046511628,78
Alapaʻi,30,22,52,0.5769230769230769,78
Haʻaheo,23,14,37,0.6216216216216216,78
Hana,47,48,95,0.49473684210526314,78
Haole,24,22,46,0.5217391304347826,78
Hina,31,14,45,0.6888888888888889,78
ʻEhu,29,18,47,0.6170212765957447,78
Kahananui,52,43,95,0.5473684210526316,78
Kaheana,56,25,81,0.691358024691358,78
Kahele,84,49,133,0.631578947368421,78
Kahili/Kāhili,28,14,42,0.6666666666666666,78
Kahinu,33,20,53,0.6226415094339622,78
Kahue,77,70,147,0.5238095238095238,78
Kahuhu,18,22,40,0.45,78
Kaʻaeʻa,25,17,42,0.5952380952380952,78
Kaʻahanui,34,21,55,0.6181818181818182,78
Kaʻai,36,26,62,0.5806451612903226,78
Kaʻaihue,38,23,61,0.6229508196721312,78
Kaʻākau,42,27,69,0.6086956521739131,78
Kaʻanāʻanā,77,64,141,0.5460992907801419,78
Kaʻaua/Kaʻauʻa,57,41,98,0.5816326530612245,78
Kaʻaukai,43,27,70,0.6142857142857143,78
Kaʻawa,33,20,53,0.6226415094339622,78
Kaʻili,56,38,94,0.5957446808510638,78
Kaʻilianu,29,22,51,0.5686274509803921,78
Kaiʻa,48,29,77,0.6233766233766234,78
Kaina,21,26,47,0.44680851063829785,78
Kaipo,26,16,42,0.6190476190476191,78
Kaiwi,52,45,97,0.5360824742268041,78
Kalā/Kala,33,16,49,0.673469387755102,78
Kalama,77,51,128,0.6015625,78
Kalawaiʻa,52,47,99,0.5252525252525253,78
Kalehua,26,16,42,0.6190476190476191,78
Kalei,22,18,40,0.55,78
Kaleo,24,19,43,0.5581395348837209,78
Kalili,42,34,76,0.5526315789473685,78
Kalua,180,147,327,0.5504587155963303,78
Ahia,22,21,43,0.5116279069767442,79
Alapaʻi,28,24,52,0.5384615384615384,79
Haʻaheo,27,10,37,0.7297297297297297,79
Hana,60,35,95,0.631578947368421,79
Haole,29,17,46,0.6304347826086957,79
Hina,28,17,45,0.6222222222222222,79
ʻEhu,30,17,47,0.6382978723404256,79
Kahananui,58,37,95,0.6105263157894737,79
Kaheana,47,34,81,0.5802469135802469,79
Kahele,78,55,133,0.5864661654135338,79
Kahili/Kāhili,28,14,42,0.6666666666666666,79
Kahinu,33,20,53,0.6226415094339622,79
Kahue,84,63,147,0.5714285714285714,79
Kahuhu,26,14,40,0.65,79
Kaʻaeʻa,29,13,42,0.6904761904761905,79
Kaʻahanui,34,21,55,0.6181818181818182,79
Kaʻai,36,26,62,0.5806451612903226,79
Kaʻaihue,37,24,61,0.6065573770491803,79
Kaʻākau,39,30,69,0.5652173913043478,79
Kaʻanāʻanā,79,62,141,0.5602836879432624,79
Kaʻaua/Kaʻauʻa,49,49,98,0.5,79
Kaʻaukai,44,26,70,0.6285714285714286,79
Kaʻawa,29,24,53,0.5471698113207547,79
Kaʻili,53,41,94,0.5638297872340425,79
Kaʻilianu,27,24,51,0.5294117647058824,79
Kaiʻa,36,41,77,0.4675324675324675,79
Kaina,24,23,47,0.5106382978723404,79
Kaipo,20,22,42,0.47619047619047616,79
Kaiwi,58,39,97,0.5979381443298969,79
Kalā/Kala,34,15,49,0.6938775510204082,79
Kalama,75,53,128,0.5859375,79
Kalawaiʻa,59,40,99,0.5959595959595959,79
Kalehua,16,26,42,0.38095238095238093,79
Kalei,27,13,40,0.675,79
Kaleo,26,17,43,0.6046511627906976,79
Kalili,47,29,76,0.618421052631579,79
Kalua,178,149,327,0.5443425076452599,79
Ahia,27,16,43,0.627906976744186,80
Alapaʻi,30,22,52,0.5769230769230769,80
Haʻaheo,25,12,37,0.6756756756756757,80
Hana,48,47,95,0.5052631578947369,80
Haole,25,21,46,0.5434782608695652,80
Hina,27,18,45,0.6,80
ʻEhu,28,19,47,0.5957446808510638,80
Kahananui,57,38,95,0.6,80
Kaheana,47,34,81,0.5802469135802469,80
Kahele,79,54,133,0.5939849624060151,80
Kahili/Kāhili,19,23,42,0.4523809523809524,80
Kahinu,24,29,53,0.4528301886792453,80
Kahue,88,59,147,0.5986394557823129,80
Kahuhu,23,17,40,0.575,80
Kaʻaeʻa,26,16,42,0.6190476190476191,80
Kaʻahanui,27,28,55,0.4909090909090909,80
Kaʻai,38,24,62,0.6129032258064516,80
Kaʻaihue,35,26,61,0.5737704918032787,80
Kaʻākau,43,26,69,0.6231884057971014,80
Kaʻanāʻanā,79,62,141,0.5602836879432624,80
Kaʻaua/Kaʻauʻa,52,46,98,0.5306122448979592,80
Kaʻaukai,36,34,70,0.5142857142857142,80
Kaʻawa,36,17,53,0.6792452830188679,80
Kaʻili,55,39,94,0.5851063829787234,80
Kaʻilianu,34,17,51,0.6666666666666666,80
Kaiʻa,40,37,77,0.5194805194805194,80
Kaina,30,17,47,0.6382978723404256,80
Kaipo,22,20,42,0.5238095238095238,80
Kaiwi,63,34,97,0.6494845360824743,80
Kalā/Kala,25,24,49,0.5102040816326531,80
Kalama,83,45,128,0.6484375,80
Kalawaiʻa,51,48,99,0.5151515151515151,80
Kalehua,19,23,42,0.4523809523809524,80
Kalei,24,16,40,0.6,80
Kaleo,31,12,43,0.7209302325581395,80
Kalili,51,25,76,0.6710526315789473,80
Kalua,187,140,327,0.5718654434250765,80
Ahia,28,15,43,0.6511627906976745,81
Alapaʻi,33,19,52,0.6346153846153846,81
Haʻaheo,22,15,37,0.5945945945945946,81
Hana,58,37,95,0.6105263157894737,81
Haole,26,20,46,0.5652173913043478,81
Hina,20,25,45,0.4444444444444444,81
ʻEhu,28,19,47,0.5957446808510638,81
Kahananui,56,39,95,0.5894736842105263,81
Kaheana,48,33,81,0.5925925925925926,81
Kahele,88,45,133,0.6616541353383458,81
Kahili/Kāhili,23,19,42,0.5476190476190477,81
Kahinu,29,24,53,0.5471698113207547,81
Kahue,80,67,147,0.54421768707483,81
Kahuhu,24,16,40,0.6,81
Kaʻaeʻa,26,16,42,0.6190476190476191,81
Kaʻahanui,31,24,55,0.5636363636363636,81
Kaʻai,36,26,62,0.5806451612903226,81
Kaʻaihue,35,26,61,0.5737704918032787,81
Kaʻākau,38,31,69,0.5507246376811594,81
Kaʻanāʻanā,83,58,141,0.5886524822695035,81
Kaʻaua/Kaʻauʻa,51,47,98,0.5204081632653061,81
Kaʻaukai,42,28,70,0.6,81
Kaʻawa,27,26,53,0.5094339622641509,81
Kaʻili,60,34,94,0.6382978723404256,81
Kaʻilianu,32,19,51,0.6274509803921569,81
Kaiʻa,42,35,77,0.5454545454545454,81
Kaina,25,22,47,0.5319148936170213,81
Kaipo,24,18,42,0.5714285714285714,81
Kaiwi,59,38,97,0.6082474226804123,81
Kalā/Kala,20,29,49,0.40816326530612246,81
Kalama,79,49,128,0.6171875,81
Kalawaiʻa,58,41,99,0.5858585858585859,81
Kalehua,29,13,42,0.6904761904761905,81
Kalei,24,16,40,0.6,81
Kaleo,27,16,43,0.627906976744186,81
Kalili,46,30,76,0.6052631578947368,81
Kalua,177,150,327,0.5412844036697247,81
Ahia,24,19,43,0.5581395348837209,82
Alapaʻi,30,22,52,0.5769230769230769,82
Haʻaheo,20,17,37,0.5405405405405406,82
Hana,52,43,95,0.5473684210526316,82
Haole,28,18,46,0.6086956521739131,82
Hina,22,23,45,0.4888888888888889,82
ʻEhu,26,21,47,0.5531914893617021,82
Kahananui,55,40,95,0.5789473684210527,82
Kaheana,50,31,81,0.6172839506172839,82
Kahele,89,44,133,0.6691729323308271,82
Kahili/Kāhili,29,13,42,0.6904761904761905,82
Kahinu,33,20,53,0.6226415094339622,82
Kahue,86,61,147,0.5850340136054422,82
Kahuhu,20,20,40,0.5,82
Kaʻaeʻa,22,20,42,0.5238095238095238,82
Kaʻahanui,37,18,55,0.6727272727272727,82
Kaʻai,38,24,62,0.6129032258064516,82
Kaʻaihue,31,30,61,0.5081967213114754,82
Kaʻākau,37,32,69,0.5362318840579711,82
Kaʻanāʻanā,77,64,141,0.5460992907801419,82
Kaʻaua/Kaʻauʻa,61,37,98,0.6224489795918368,82
Kaʻaukai,42,28,70,0.6,82
Kaʻawa,26,27,53,0.49056603773584906,82
Kaʻili,60,34,94,0.6382978723404256,82
Kaʻilianu,27,24,51,0.5294117647058824,82
Kaiʻa,42,35,77,0.5454545454545454,82
Kaina,29,18,47,0.6170212765957447,82
Kaipo,24,18,42,0.5714285714285714,82
Kaiwi,56,41,97,0.5773195876288659,82
Kalā/Kala,31,18,49,0.6326530612244898,82
Kalama,71,57,128,0.5546875,82
Kalawaiʻa,61,38,99,0.6161616161616161,82
Kalehua,24,18,42,0.5714285714285714,82
Kalei,19,21,40,0.475,82
Kaleo,23,20,43,0.5348837209302325,82
Kalili,47,29,76,0.618421052631579,82
Kalua,185,142,327,0.5657492354740061,82
Ahia,26,17,43,0.6046511627906976,83
Alapaʻi,33,19,52,0.6346153846153846,83
Haʻaheo,21,16,37,0.5675675675675675,83
Hana,56,39,95,0.5894736842105263,83
Haole,29,17,46,0.6304347826086957,83
Hina,23,22,45,0.5111111111111111,83
ʻEhu,26,21,47,0.5531914893617021,83
Kahananui,66,29,95,0.6947368421052632,83
Kaheana,46,35,81,0.5679012345679012,83
Kahele,66,67,133,0.49624060150375937,83
Kahili/Kāhili,21,21,42,0.5,83
Kahinu,35,18,53,0.660377358490566,83
Kahue,80,67,147,0.54421768707483,83
Kahuhu,20,20,40,0.5,83
Kaʻaeʻa,24,18,42,0.5714285714285714,83
Kaʻahanui,28,27,55,0.509090909090909,83
Kaʻai,34,28,62,0.5483870967741935,83
Kaʻaihue,31,30,61,0.5081967213114754,83
Kaʻākau,38,31,69,0.5507246376811594,83
Kaʻanāʻanā,84,57,141,0.5957446808510638,83
Kaʻaua/Kaʻauʻa,58,40,98,0.5918367346938775,83
Kaʻaukai,44,26,70,0.6285714285714286,83
Kaʻawa,31,22,53,0.5849056603773585,83
Kaʻili,45,49,94,0.4787234042553192,83
Kaʻilianu,32,19,51,0.6274509803921569,83
Kaiʻa,45,32,77,0.5844155844155844,83
Kaina,28,19,47,0.5957446808510638,83
Kaipo,27,15,42,0.6428571428571429,83
Kaiwi,56,41,97,0.5773195876288659,83
Kalā/Kala,26,23,49,0.5306122448979592,83
Kalama,84,44,128,0.65625,83
Kalawaiʻa,58,41,99,0.5858585858585859,83
Kalehua,26,16,42,0.6190476190476191,83
Kalei,21,19,40,0.525,83
Kaleo,25,18,43,0.5813953488372093,83
Kalili,41,35,76,0.5394736842105263,83
Kalua,200,127,327,0.6116207951070336,83
Ahia,25,18,43,0.5813953488372093,84
Alapaʻi,28,24,52,0.5384615384615384,84
Haʻaheo,21,16,37,0.5675675675675675,84
Hana,57,38,95,0.6,84
Haole,27,19,46,0.5869565217391305,84
Hina,27,18,45,0.6,84
ʻEhu,24,23,47,0.5106382978723404,84
Kahananui,50,45,95,0.5263157894736842,84
Kaheana,38,43,81,0.4691358024691358,84
Kahele,81,52,133,0.6090225563909775,84
Kahili/Kāhili,27,15,42,0.6428571428571429,84
Kahinu,31,22,53,0.5849056603773585,84
Kahue,83,64,147,0.564625850340136,84
Kahuhu,21,19,40,0.525,84
Kaʻaeʻa,27,15,42,0.6428571428571429,84
Kaʻahanui,36,19,55,0.6545454545454545,84
Kaʻai,30,32,62,0.4838709677419355,84
Kaʻaihue,42,19,61,0.6885245901639344,84
Kaʻākau,38,31,69,0.5507246376811594,84
Kaʻanāʻanā,83,58,141,0.5886524822695035,84
Kaʻaua/Kaʻauʻa,57,41,98,0.5816326530612245,84
Kaʻaukai,42,28,70,0.6,84
Kaʻawa,27,26,53,0.5094339622641509,84
Kaʻili,63,31,94,0.6702127659574468,84
Kaʻilianu,26,25,51,0.5098039215686274,84
Kaiʻa,48,29,77,0.6233766233766234,84
Kaina,21,26,47,0.44680851063829785,84
Kaipo,25,17,42,0.5952380952380952,84
Kaiwi,57,40,97,0.5876288659793815,84
Kalā/Kala,25,24,49,0.5102040816326531,84
Kalama,77,51,128,0.6015625,84
Kalawaiʻa,56,43,99,0.5656565656565656,84
Kalehua,32,10,42,0.7619047619047619,84
Kalei,22,18,40,0.55,84
Kaleo,27,16,43,0.627906976744186,84
Kalili,46,30,76,0.6052631578947368,84
Kalua,187,140,327,0.5718654434250765,84
Ahia,24,19,43,0.5581395348837209,85
Alapaʻi,29,23,52,0.5576923076923077,85
Haʻaheo,21,16,37,0.5675675675675675,85
Hana,56,39,95,0.5894736842105263,85
Haole,24,22,46,0.5217391304347826,85
Hina,26,19,45,0.5777777777777777,85
ʻEhu,26,21,47,0.5531914893617021,85
Kahananui,63,32,95,0.6631578947368421,85
Kaheana,44,37,81,0.5432098765432098,85
Kahele,74,59,133,0.556390977443609,85
Kahili/Kāhili,29,13,42,0.6904761904761905,85
Kahinu,26,27,53,0.49056603773584906,85
Kahue,88,59,147,0.5986394557823129,85
Kahuhu,25,15,40,0.625,85
Kaʻaeʻa,23,19,42,0.5476190476190477,85
Kaʻahanui,35,20,55,0.6363636363636364,85
Kaʻai,33,29,62,0.532258064516129,85
Kaʻaihue,39,22,61,0.639344262295082,85
Kaʻākau,40,29,69,0.5797101449275363,85
Kaʻanāʻanā,84,57,141,0.5957446808510638,85
Kaʻaua/Kaʻauʻa,57,41,98,0.5816326530612245,85
Kaʻaukai,37,33,70,0.5285714285714286,85
Kaʻawa,31,22,53,0.5849056603773585,85
Kaʻili,58,36,94,0.6170212765957447,85
Kaʻilianu,33,18,51,0.6470588235294118,85
Kaiʻa,43,34,77,0.5584415584415584,85
Kaina,26,21,47,0.5531914893617021,85
Kaipo,24,18,42,0.5714285714285714,85
Kaiwi,55,42,97,0.5670103092783505,85
Kalā/Kala,31,18,49,0.6326530612244898,85
Kalama,71,57,128,0.5546875,85
Kalawaiʻa,55,44,99,0.5555555555555556,85
Kalehua,24,18,42,0.5714285714285714,85
Kalei,18,22,40,0.45,85
Kaleo,23,20,43,0.5348837209302325,85
Kalili,44,32,76,0.5789473684210527,85
Kalua,195,132,327,0.5963302752293578,85
Ahia,26,17,43,0.6046511627906976,86
Alapaʻi,33,19,52,0.6346153846153846,86
Haʻaheo,24,13,37,0.6486486486486487,86
Hana,58,37,95,0.6105263157894737,86
Haole,25,21,46,0.5434782608695652,86
Hina,21,24,45,0.4666666666666667,86
ʻEhu,30,17,47,0.6382978723404256,86
Kahananui,49,46,95,0.5157894736842106,86
Kaheana,45,36,81,0.5555555555555556,86
Kahele,75,58,133,0.5639097744360902,86
Kahili/Kāhili,19,23,42,0.4523809523809524,86
Kahinu,30,23,53,0.5660377358490566,86
Kahue,77,70,147,0.5238095238095238,86
Kahuhu,28,12,40,0.7,86
Kaʻaeʻa,31,11,42,0.7380952380952381,86
Kaʻahanui,30,25,55,0.5454545454545454,86
Kaʻai,38,24,62,0.6129032258064516,86
Kaʻaihue,31,30,61,0.5081967213114754,86
Kaʻākau,41,28,69,0.5942028985507246,86
Kaʻanāʻanā,77,64,141,0.5460992907801419,86
Kaʻaua/Kaʻauʻa,62,36,98,0.6326530612244898,86
Kaʻaukai,32,38,70,0.45714285714285713,86
Kaʻawa,28,25,53,0.5283018867924528,86
Kaʻili,58,36,94,0.6170212765957447,86
Kaʻilianu,32,19,51,0.6274509803921569,86
Kaiʻa,44,33,77,0.5714285714285714,86
Kaina,24,23,47,0.5106382978723404,86
Kaipo,23,19,42,0.5476190476190477,86
Kaiwi,54,43,97,0.5567010309278351,86
Kalā/Kala,28,21,49,0.5714285714285714,86
Kalama,85,43,128,0.6640625,86
Kalawaiʻa,50,49,99,0.5050505050505051,86
Kalehua,27,15,42,0.6428571428571429,86
Kalei,21,19,40,0.525,86
Kaleo,30,13,43,0.6976744186046512,86
Kalili,48,28,76,0.631578947368421,86
Kalua,200,127,327,0.6116207951070336,86
Ahia,29,14,43,0.6744186046511628,87
Alapaʻi,31,21,52,0.5961538461538461,87
Haʻaheo,22,15,37,0.5945945945945946,87
Hana,58,37,95,0.6105263157894737,87
Haole,21,25,46,0.45652173913043476,87
Hina,28,17,45,0.6222222222222222,87
ʻEhu,27,20,47,0.574468085106383,87
Kahananui,57,38,95,0.6,87
Kaheana,44,37,81,0.5432098765432098,87
Kahele,82,51,133,0.6165413533834586,87
Kahili/Kāhili,21,21,42,0.5,87
Kahinu,32,21,53,0.6037735849056604,87
Kahue,80,67,147,0.54421768707483,87
Kahuhu,17,23,40,0.425,87
Kaʻaeʻa,26,16,42,0.6190476190476191,87
Kaʻahanui,37,18,55,0.6727272727272727,87
Kaʻai,39,23,62,0.6290322580645161,87
Kaʻaihue,37,24,61,0.6065573770491803,87
Kaʻākau,39,30,69,0.5652173913043478,87
Kaʻanāʻanā,80,61,141,0.5673758865248227,87
Kaʻaua/Kaʻauʻa,54,44,98,0.5510204081632653,87
Kaʻaukai,40,30,70,0.5714285714285714,87
Kaʻawa,34,19,53,0.6415094339622641,87
Kaʻili,51,43,94,0.5425531914893617,87
Kaʻilianu,33,18,51,0.6470588235294118,87
Kaiʻa,41,36,77,0.5324675324675324,87
Kaina,28,19,47,0.5957446808510638,87
Kaipo,27,15,42,0.6428571428571429,87
Kaiwi,64,33,97,0.6597938144329897,87
Kalā/Kala,30,19,49,0.6122448979591837,87
Kalama,70,58,128,0.546875,87
Kalawaiʻa,51,48,99,0.5151515151515151,87
Kalehua,19,23,42,0.4523809523809524,87
Kalei,26,14,40,0.65,87
Kaleo,25,18,43,0.5813953488372093,87
Kalili,40,36,76,0.5263157894736842,87
Kalua,194,133,327,0.5932721712538226,87
Ahia,25,18,43,0.5813953488372093,88
Alapaʻi,26,26,52,0.5,88
Haʻaheo,22,15,37,0.5945945945945946,88
Hana,63,32,95,0.6631578947368421,88
Haole,22,24,46,0.4782608695652174,88
Hina,31,14,45,0.6888888888888889,88
ʻEhu,25,22,47,0.5319148936170213,88
Kahananui,55,40,95,0.5789473684210527,88
Kaheana,49,32,81,0.6049382716049383,88
Kahele,80,53,133,0.6015037593984962,88
Kahili/Kāhili,22,20,42,0.5238095238095238,88
Kahinu,30,23,53,0.5660377358490566,88
Kahue,86,61,147,0.5850340136054422,88
Kahuhu,21,19,40,0.525,88
Kaʻaeʻa,25,17,42,0.5952380952380952,88
Kaʻahanui,30,25,55,0.5454545454545454,88
Kaʻai,33,29,62,0.532258064516129,88
Kaʻaihue,33,28,61,0.5409836065573771,88
Kaʻākau,36,33,69,0.5217391304347826,88
Kaʻanāʻanā,84,57,141,0.5957446808510638,88
Kaʻaua/Kaʻauʻa,67,31,98,0.6836734693877551,88
Kaʻaukai,38,32,70,0.5428571428571428,88
Kaʻawa,31,22,53,0.5849056603773585,88
Kaʻili,56,38,94,0.5957446808510638,88
Kaʻilianu,26,25,51,0.5098039215686274,88
Kaiʻa,46,31,77,0.5974025974025974,88
Kaina,26,21,47,0.5531914893617021,88
Kaipo,18,24,42,0.42857142857142855,88
Kaiwi,58,39,97,0.5979381443298969,88
Kalā/Kala,24,25,49,0.4897959183673469,88
Kalama,66,62,128,0.515625,88
Kalawaiʻa,59,40,99,0.5959595959595959,88
Kalehua,27,15,42,0.6428571428571429,88
Kalei,27,13,40,0.675,88
Kaleo,29,14,43,0.6744186046511628,88
Kalili,48,28,76,0.631578947368421,88
Kalua,190,137,327,0.581039755351682,88
Ahia,32,11,43,0.7441860465116279,89
Alapaʻi,32,20,52,0.6153846153846154,89
Haʻaheo,20,17,37,0.5405405405405406,89
Hana,49,46,95,0.5157894736842106,89
Haole,26,20,46,0.5652173913043478,89
Hina,26,19,45,0.5777777777777777,89
ʻEhu,23,24,47,0.48936170212765956,89
Kahananui,57,38,95,0.6,89
Kaheana,51,30,81,0.6296296296296297,89
Kahele,82,51,133,0.6165413533834586,89
Kahili/Kāhili,21,21,42,0.5,89
Kahinu,25,28,53,0.4716981132075472,89
Kahue,87,60,147,0.5918367346938775,89
Kahuhu,24,16,40,0.6,89
Kaʻaeʻa,21,21,42,0.5,89
Kaʻahanui,27,28,55,0.4909090909090909,89
Kaʻai,33,29,62,0.532258064516129,89
Kaʻaihue,40,21,61,0.6557377049180327,89
Kaʻākau,42,27,69,0.6086956521739131,89
Kaʻanāʻanā,86,55,141,0.6099290780141844,89
Kaʻaua/Kaʻauʻa,57,41,98,0.5816326530612245,89
Kaʻaukai,39,31,70,0.5571428571428572,89
Kaʻawa,23,30,53,0.4339622641509434,89
Kaʻili,51,43,94,0.5425531914893617,89
Kaʻilianu,28,23,51,0.5490196078431373,89
Kaiʻa,46,31,77,0.5974025974025974,89
Kaina,30,17,47,0.6382978723404256,89
Kaipo,20,22,42,0.47619047619047616,89
Kaiwi,55,42,97,0.5670103092783505,89
Kalā/Kala,33,16,49,0.673469387755102,89
Kalama,79,49,128,0.6171875,89
Kalawaiʻa,67,32,99,0.6767676767676768,89
Kalehua,24,18,42,0.5714285714285714,89
Kalei,25,15,40,0.625,89
Kaleo,25,18,43,0.5813953488372093,89
Kalili,50,26,76,0.6578947368421053,89
Kalua,178,149,327,0.5443425076452599,89
Ahia,23,20,43,0.5348837209302325,90
Alapaʻi,31,21,52,0.5961538461538461,90
Haʻaheo,24,13,37,0.6486486486486487,90
Hana,58,37,95,0.6105263157894737,90
Haole,20,26,46,0.43478260869565216,90
Hina,29,16,45,0.6444444444444445,90
ʻEhu,26,21,47,0.5531914893617021,90
Kahananui,51,44,95,0.5368421052631579,90
Kaheana,50,31,81,0.6172839506172839,90
Kahele,87,46,133,0.6541353383458647,90
Kahili/Kāhili,27,15,42,0.6428571428571429,90
Kahinu,39,14,53,0.7358490566037735,90
Kahue,86,61,147,0.5850340136054422,90
Kahuhu,21,19,40,0.525,90
Kaʻaeʻa,24,18,42,0.5714285714285714,90
Kaʻahanui,25,30,55,0.45454545454545453,90
Kaʻai,40,22,62,0.6451612903225806,90
Kaʻaihue,29,32,61,0.47540983606557374,90
Kaʻākau,44,25,69,0.6376811594202898,90
Kaʻanāʻanā,87,54,141,0.6170212765957447,90
Kaʻaua/Kaʻauʻa,54,44,98,0.5510204081632653,90
Kaʻaukai,41,29,70,0.5857142857142857,90
Kaʻawa,31,22,53,0.5849056603773585,90
Kaʻili,57,37,94,0.6063829787234043,90
Kaʻilianu,29,22,51,0.5686274509803921,90
Kaiʻa,37,40,77,0.4805194805194805,90
Kaina,32,15,47,0.6808510638297872,90
Kaipo,18,24,42,0.42857142857142855,90
Kaiwi,59,38,97,0.6082474226804123,90
Kalā/Kala,33,16,49,0.673469387755102,90
Kalama,65,63,128,0.5078125,90
Kalawaiʻa,54,45,99,0.5454545454545454,90
Kalehua,25,17,42,0.5952380952380952,90
Kalei,22,18,40,0.55,90
Kaleo,25,18,43,0.5813953488372093,90
Kalili,53,23,76,0.6973684210526315,90
Kalua,178,149,327,0.5443425076452599,90
Ahia,24,19,43,0.5581395348837209,91
Alapaʻi,37,15,52,0.7115384615384616,91
Haʻaheo,20,17,37,0.5405405405405406,91
Hana,59,36,95,0.6210526315789474,91
Haole,28,18,46,0.6086956521739131,91
Hina,21,24,45,0.4666666666666667,91
ʻEhu,30,17,47,0.6382978723404256,91
Kahananui,55,40,95,0.5789473684210527,91
Kaheana,47,34,81,0.5802469135802469,91
Kahele,74,59,133,0.556390977443609,91
Kahili/Kāhili,23,19,42,0.5476190476190477,91
Kahinu,31,22,53,0.5849056603773585,91
Kahue,78,69,147,0.5306122448979592,91
Kahuhu,21,19,40,0.525,91
Kaʻaeʻa,29,13,42,0.6904761904761905,91
Kaʻahanui,25,30,55,0.45454545454545453,91
Kaʻai,36,26,62,0.5806451612903226,91
Kaʻaihue,41,20,61,0.6721311475409836,91
Kaʻākau,37,32,69,0.5362318840579711,91
Kaʻanāʻanā,85,56,141,0.6028368794326241,91
Kaʻaua/Kaʻauʻa,57,41,98,0.5816326530612245,91
Kaʻaukai,41,29,70,0.5857142857142857,91
Kaʻawa,28,25,53,0.5283018867924528,91
Kaʻili,62,32,94,0.6595744680851063,91
Kaʻilianu,35,16,51,0.6862745098039216,91
Kaiʻa,48,29,77,0.6233766233766234,91
Kaina,24,23,47,0.5106382978723404,91
Kaipo,24,18,42,0.5714285714285714,91
Kaiwi,56,41,97,0.5773195876288659,91
Kalā/Kala,27,22,49,0.5510204081632653,91
Kalama,82,46,128,0.640625,91
Kalawaiʻa,53,46,99,0.5353535353535354,91
Kalehua,23,19,42,0.5476190476190477,91
Kalei,32,8,40,0.8,91
Kaleo,24,19,43,0.5581395348837209,91
Kalili,43,33,76,0.5657894736842105,91
Kalua,174,153,327,0.5321100917431193,91
Ahia,21,22,43,0.4883720930232558,92
Alapaʻi,32,20,52,0.6153846153846154,92
Haʻaheo,26,11,37,0.7027027027027027,92
Hana,54,41,95,0.5684210526315789,92
Haole,31,15,46,0.6739130434782609,92
Hina,24,21,45,0.5333333333333333,92
ʻEhu,28,19,47,0.5957446808510638,92
Kahananui,58,37,95,0.6105263157894737,92
Kaheana,49,32,81,0.6049382716049383,92
Kahele,83,50,133,0.6240601503759399,92
Kahili/Kāhili,17,25,42,0.40476190476190477,92
Kahinu,28,25,53,0.5283018867924528,92
Kahue,88,59,147,0.5986394557823129,92
Kahuhu,23,17,40,0.575,92
Kaʻaeʻa,25,17,42,0.5952380952380952,92
Kaʻahanui,31,24,55,0.5636363636363636,92
Kaʻai,34,28,62,0.5483870967741935,92
Kaʻaihue,34,27,61,0.5573770491803278,92
Kaʻākau,39,30,69,0.5652173913043478,92
Kaʻanāʻanā,91,50,141,0.6453900709219859,92
Kaʻaua/Kaʻauʻa,50,48,98,0.5102040816326531,92
Kaʻaukai,37,33,70,0.5285714285714286,92
Kaʻawa,29,24,53,0.5471698113207547,92
Kaʻili,56,38,94,0.5957446808510638,92
Kaʻilianu,34,17,51,0.6666666666666666,92
Kaiʻa,49,28,77,0.6363636363636364,92
Kaina,23,24,47,0.48936170212765956,92
Kaipo,23,19,42,0.5476190476190477,92
Kaiwi,61,36,97,0.6288659793814433,92
Kalā/Kala,27,22,49,0.5510204081632653,92
Kalama,75,53,128,0.5859375,92
Kalawaiʻa,56,43,99,0.5656565656565656,92
Kalehua,29,13,42,0.6904761904761905,92
Kalei,17,23,40,0.425,92
Kaleo,24,19,43,0.5581395348837209,92
Kalili,42,34,76,0.5526315789473685,92
Kalua,186,141,327,0.5688073394495413,92
Ahia,23,20,43,0.5348837209302325,93
Alapaʻi,32,20,52,0.6153846153846154,93
Haʻaheo,18,19,37,0.4864864864864865,93
Hana,58,37,95,0.6105263157894737,93
Haole,31,15,46,0.6739130434782609,93
Hina,30,15,45,0.6666666666666666,93
ʻEhu,31,16,47,0.6595744680851063,93
Kahananui,55,40,95,0.5789473684210527,93
Kaheana,44,37,81,0.5432098765432098,93
Kahele,78,55,133,0.5864661654135338,93
Kahili/Kāhili,27,15,42,0.6428571428571429,93
Kahinu,26,27,53,0.49056603773584906,93
Kahue,90,57,147,0.6122448979591837,93
Kahuhu,21,19,40,0.525,93
Kaʻaeʻa,25,17,42,0.5952380952380952,93
Kaʻahanui,25,30,55,0.45454545454545453,93
Kaʻai,41,21,62,0.6612903225806451,93
Kaʻaihue,27,34,61,0.4426229508196721,93
Kaʻākau,35,34,69,0.5072463768115942,93
Kaʻanāʻanā,81,60,141,0.574468085106383,93
Kaʻaua/Kaʻauʻa,48,50,98,0.4897959183673469,93
Kaʻaukai,43,27,70,0.6142857142857143,93
Kaʻawa,20,33,53,0.37735849056603776,93
Kaʻili,56,38,94,0.5957446808510638,93
Kaʻilianu,27,24,51,0.5294117647058824,93
Kaiʻa,42,35,77,0.5454545454545454,93
Kaina,34,13,47,0.723404255319149,93
Kaipo,26,16,42,0.6190476190476191,93
Kaiwi,59,38,97,0.6082474226804123,93
Kalā/Kala,32,17,49,0.6530612244897959,93
Kalama,77,51,128,0.6015625,93
Kalawaiʻa,59,40,99,0.5959595959595959,93
Kalehua,25,17,42,0.5952380952380952,93
Kalei,22,18,40,0.55,93
Kaleo,30,13,43,0.6976744186046512,93
Kalili,53,23,76,0.6973684210526315,93
Kalua,183,144,327,0.5596330275229358,93
Ahia,23,20,43,0.5348837209302325,94
Alapaʻi,25,27,52,0.4807692307692308,94
Haʻaheo,22,15,37,0.5945945945945946,94
Hana,56,39,95,0.5894736842105263,94
Haole,26,20,46,0.5652173913043478,94
Hina,30,15,45,0.6666666666666666,94
ʻEhu,28,19,47,0.5957446808510638,94
Kahananui,56,39,95,0.5894736842105263,94
Kaheana,50,31,81,0.6172839506172839,94
Kahele,82,51,133,0.6165413533834586,94
Kahili/Kāhili,25,17,42,0.5952380952380952,94
Kahinu,33,20,53,0.6226415094339622,94
Kahue,85,62,147,0.5782312925170068,94
Kahuhu,28,12,40,0.7,94
Kaʻaeʻa,26,16,42,0.6190476190476191,94
Kaʻahanui,28,27,55,0.509090909090909,94
Kaʻai,32,30,62,0.5161290322580645,94
Kaʻaihue,39,22,61,0.639344262295082,94
Kaʻākau,39,30,69,0.5652173913043478,94
Kaʻanāʻanā,81,60,141,0.574468085106383,94
Kaʻaua/Kaʻauʻa,53,45,98,0.5408163265306123,94
Kaʻaukai,41,29,70,0.5857142857142857,94
Kaʻawa,27,26,53,0.5094339622641509,94
Kaʻili,55,39,94,0.5851063829787234,94
Kaʻilianu,31,20,51,0.6078431372549019,94
Kaiʻa,43,34,77,0.5584415584415584,94
Kaina,24,23,47,0.5106382978723404,94
Kaipo,21,21,42,0.5,94
Kaiwi,56,41,97,0.5773195876288659,94
Kalā/Kala,30,19,49,0.6122448979591837,94
Kalama,79,49,128,0.6171875,94
Kalawaiʻa,58,41,99,0.5858585858585859,94
Kalehua,27,15,42,0.6428571428571429,94
Kalei,24,16,40,0.6,94
Kaleo,29,14,43,0.6744186046511628,94
Kalili,43,33,76,0.5657894736842105,94
Kalua,179,148,327,0.5474006116207951,94
Ahia,28,15,43,0.6511627906976745,95
Alapaʻi,28,24,52,0.5384615384615384,95
Haʻaheo,27,10,37,0.7297297297297297,95
Hana,63,32,95,0.6631578947368421,95
Haole,29,17,46,0.6304347826086957,95
Hina,28,17,45,0.6222222222222222,95
ʻEhu,32,15,47,0.6808510638297872,95
Kahananui,57,38,95,0.6,95
Kaheana,55,26,81,0.6790123456790124,95
Kahele,75,58,133,0.5639097744360902,95
Kahili/Kāhili,20,22,42,0.47619047619047616,95
Kahinu,30,23,53,0.5660377358490566,95
Kahue,85,62,147,0.5782312925170068,95
Kahuhu,24,16,40,0.6,95
Kaʻaeʻa,21,21,42,0.5,95
Kaʻahanui,34,21,55,0.6181818181818182,95
Kaʻai,41,21,62,0.6612903225806451,95
Kaʻaihue,37,24,61,0.6065573770491803,95
Kaʻākau,41,28,69,0.5942028985507246,95
Kaʻanāʻanā,83,58,141,0.5886524822695035,95
Kaʻaua/Kaʻauʻa,53,45,98,0.5408163265306123,95
Kaʻaukai,40,30,70,0.5714285714285714,95
Kaʻawa,30,23,53,0.5660377358490566,95
Kaʻili,61,33,94,0.648936170212766,95
Kaʻilianu,28,23,51,0.5490196078431373,95
Kaiʻa,45,32,77,0.5844155844155844,95
Kaina,26,21,47,0.5531914893617021,95
Kaipo,23,19,42,0.5476190476190477,95
Kaiwi,52,45,97,0.5360824742268041,95
Kalā/Kala,31,18,49,0.6326530612244898,95
Kalama,65,63,128,0.5078125,95
Kalawaiʻa,53,46,99,0.5353535353535354,95
Kalehua,21,21,42,0.5,95
Kalei,17,23,40,0.425,95
Kaleo,23,20,43,0.5348837209302325,95
Kalili,41,35,76,0.5394736842105263,95
Kalua,187,140,327,0.5718654434250765,95
Ahia,25,18,43,0.5813953488372093,96
Alapaʻi,32,20,52,0.6153846153846154,96
Haʻaheo,24,13,37,0.6486486486486487,96
Hana,56,39,95,0.5894736842105263,96
Haole,26,20,46,0.5652173913043478,96
Hina,33,12,45,0.7333333333333333,96
ʻEhu,30,17,47,0.6382978723404256,96
Kahananui,61,34,95,0.6421052631578947,96
Kaheana,46,35,81,0.5679012345679012,96
Kahele,75,58,133,0.5639097744360902,96
Kahili/Kāhili,24,18,42,0.5714285714285714,96
Kahinu,29,24,53,0.5471698113207547,96
Kahue,88,59,147,0.5986394557823129,96
Kahuhu,30,10,40,0.75,96
Kaʻaeʻa,31,11,42,0.7380952380952381,96
Kaʻahanui,33,22,55,0.6,96
Kaʻai,33,29,62,0.532258064516129,96
Kaʻaihue,32,29,61,0.5245901639344263,96
Kaʻākau,38,31,69,0.5507246376811594,96
Kaʻanāʻanā,76,65,141,0.5390070921985816,96
Kaʻaua/Kaʻauʻa,53,45,98,0.5408163265306123,96
Kaʻaukai,37,33,70,0.5285714285714286,96
Kaʻawa,23,30,53,0.4339622641509434,96
Kaʻili,59,35,94,0.6276595744680851,96
Kaʻilianu,28,23,51,0.5490196078431373,96
Kaiʻa,48,29,77,0.6233766233766234,96
Kaina,30,17,47,0.6382978723404256,96
Kaipo,27,15,42,0.6428571428571429,96
Kaiwi,54,43,97,0.5567010309278351,96
Kalā/Kala,31,18,49,0.6326530612244898,96
Kalama,63,65,128,0.4921875,96
Kalawaiʻa,52,47,99,0.5252525252525253,96
Kalehua,25,17,42,0.5952380952380952,96
Kalei,26,14,40,0.65,96
Kaleo,25,18,43,0.5813953488372093,96
Kalili,46,30,76,0.6052631578947368,96
Kalua,185,142,327,0.5657492354740061,96
Ahia,30,13,43,0.6976744186046512,97
Alapaʻi,27,25,52,0.5192307692307693,97
Haʻaheo,13,24,37,0.35135135135135137,97
Hana,68,27,95,0.7157894736842105,97
Haole,28,18,46,0.6086956521739131,97
Hina,22,23,45,0.4888888888888889,97
ʻEhu,30,17,47,0.6382978723404256,97
Kahananui,56,39,95,0.5894736842105263,97
Kaheana,52,29,81,0.6419753086419753,97
Kahele,68,65,133,0.5112781954887218,97
Kahili/Kāhili,25,17,42,0.5952380952380952,97
Kahinu,33,20,53,0.6226415094339622,97
Kahue,82,65,147,0.5578231292517006,97
Kahuhu,25,15,40,0.625,97
Kaʻaeʻa,23,19,42,0.5476190476190477,97
Kaʻahanui,32,23,55,0.5818181818181818,97
Kaʻai,31,31,62,0.5,97
Kaʻaihue,38,23,61,0.6229508196721312,97
Kaʻākau,41,28,69,0.5942028985507246,97
Kaʻanāʻanā,72,69,141,0.5106382978723404,97
Kaʻaua/Kaʻauʻa,55,43,98,0.5612244897959183,97
Kaʻaukai,42,28,70,0.6,97
Kaʻawa,32,21,53,0.6037735849056604,97
Kaʻili,57,37,94,0.6063829787234043,97
Kaʻilianu,30,21,51,0.5882352941176471,97
Kaiʻa,42,35,77,0.5454545454545454,97
Kaina,27,20,47,0.574468085106383,97
Kaipo,21,21,42,0.5,97
Kaiwi,57,40,97,0.5876288659793815,97
Kalā/Kala,26,23,49,0.5306122448979592,97
Kalama,87,41,128,0.6796875,97
Kalawaiʻa,65,34,99,0.6565656565656566,97
Kalehua,26,16,42,0.6190476190476191,97
Kalei,24,16,40,0.6,97
Kaleo,24,19,43,0.5581395348837209,97
Kalili,37,39,76,0.4868421052631579,97
Kalua,186,141,327,0.5688073394495413,97
Ahia,24,19,43,0.5581395348837209,98
Alapaʻi,35,17,52,0.6730769230769231,98
Haʻaheo,24,13,37,0.6486486486486487,98
Hana,50,45,95,0.5263157894736842,98
Haole,20,26,46,0.43478260869565216,98
Hina,20,25,45,0.4444444444444444,98
ʻEhu,30,17,47,0.6382978723404256,98
Kahananui,53,42,95,0.5578947368421052,98
Kaheana,42,39,81,0.5185185185185185,98
Kahele,80,53,133,0.6015037593984962,98
Kahili/Kāhili,26,16,42,0.6190476190476191,98
Kahinu,29,24,53,0.5471698113207547,98
Kahue,81,66,147,0.5510204081632653,98
Kahuhu,21,19,40,0.525,98
Kaʻaeʻa,24,18,42,0.5714285714285714,98
Kaʻahanui,33,22,55,0.6,98
Kaʻai,39,23,62,0.6290322580645161,98
Kaʻaihue,41,20,61,0.6721311475409836,98
Kaʻākau,48,21,69,0.6956521739130435,98
Kaʻanāʻanā,87,54,141,0.6170212765957447,98
Kaʻaua/Kaʻauʻa,62,36,98,0.6326530612244898,98
Kaʻaukai,41,29,70,0.5857142857142857,98
Kaʻawa,31,22,53,0.5849056603773585,98
Kaʻili,57,37,94,0.6063829787234043,98
Kaʻilianu,30,21,51,0.5882352941176471,98
Kaiʻa,46,31,77,0.5974025974025974,98
Kaina,29,18,47,0.6170212765957447,98
Kaipo,27,15,42,0.6428571428571429,98
Kaiwi,48,49,97,0.4948453608247423,98
Kalā/Kala,32,17,49,0.6530612244897959,98
Kalama,71,57,128,0.5546875,98
Kalawaiʻa,50,49,99,0.5050505050505051,98
Kalehua,25,17,42,0.5952380952380952,98
Kalei,24,16,40,0.6,98
Kaleo,25,18,43,0.5813953488372093,98
Kalili,45,31,76,0.5921052631578947,98
Kalua,184,143,327,0.5626911314984709,98
Ahia,22,21,43,0.5116279069767442,99
Alapaʻi,31,21,52,0.5961538461538461,99
Haʻaheo,27,10,37,0.7297297297297297,99
Hana,51,44,95,0.5368421052631579,99
Haole,28,18,46,0.6086956521739131,99
Hina,33,12,45,0.7333333333333333,99
ʻEhu,28,19,47,0.5957446808510638,99
Kahananui,49,46,95,0.5157894736842106,99
Kaheana,51,30,81,0.6296296296296297,99
Kahele,66,67,133,0.49624060150375937,99
Kahili/Kāhili,27,15,42,0.6428571428571429,99
Kahinu,29,24,53,0.5471698113207547,99
Kahue,88,59,147,0.5986394557823129,99
Kahuhu,17,23,40,0.425,99
Kaʻaeʻa,24,18,42,0.5714285714285714,99
Kaʻahanui,31,24,55,0.5636363636363636,99
Kaʻai,33,29,62,0.532258064516129,99
Kaʻaihue,35,26,61,0.5737704918032787,99
Kaʻākau,33,36,69,0.4782608695652174,99
Kaʻanāʻanā,91,50,141,0.6453900709219859,99
Kaʻaua/Kaʻauʻa,57,41,98,0.5816326530612245,99
Kaʻaukai,43,27,70,0.6142857142857143,99
Kaʻawa,32,21,53,0.6037735849056604,99
Kaʻili,54,40,94,0.574468085106383,99
Kaʻilianu,31,20,51,0.6078431372549019,99
Kaiʻa,46,31,77,0.5974025974025974,99
Kaina,27,20,47,0.574468085106383,99
Kaipo,24,18,42,0.5714285714285714,99
Kaiwi,54,43,97,0.5567010309278351,99
Kalā/Kala,35,14,49,0.7142857142857143,99
Kalama,64,64,128,0.5,99
Kalawaiʻa,59,40,99,0.5959595959595959,99
Kalehua,28,14,42,0.6666666666666666,99
Kalei,26,14,40,0.65,99
Kaleo,32,11,43,0.7441860465116279,99
Kalili,43,33,76,0.5657894736842105,99
Kalua,185,142,327,0.5657492354740061,99
Ahia,17,26,43,0.3953488372093023,100
Alapaʻi,31,21,52,0.5961538461538461,100
Haʻaheo,21,16,37,0.5675675675675675,100
Hana,59,36,95,0.6210526315789474,100
Haole,20,26,46,0.43478260869565216,100
Hina,30,15,45,0.6666666666666666,100
ʻEhu,32,15,47,0.6808510638297872,100
Kahananui,54,41,95,0.5684210526315789,100
Kaheana,49,32,81,0.6049382716049383,100
Kahele,85,48,133,0.6390977443609023,100
Kahili/Kāhili,25,17,42,0.5952380952380952,100
Kahinu,33,20,53,0.6226415094339622,100
Kahue,80,67,147,0.54421768707483,100
Kahuhu,22,18,40,0.55,100
Kaʻaeʻa,20,22,42,0.47619047619047616,100
Kaʻahanui,27,28,55,0.4909090909090909,100
Kaʻai,36,26,62,0.5806451612903226,100
Kaʻaihue,36,25,61,0.5901639344262295,100
Kaʻākau,43,26,69,0.6231884057971014,100
Kaʻanāʻanā,76,65,141,0.5390070921985816,100
Kaʻaua/Kaʻauʻa,62,36,98,0.6326530612244898,100
Kaʻaukai,39,31,70,0.5571428571428572,100
Kaʻawa,34,19,53,0.6415094339622641,100
Kaʻili,53,41,94,0.5638297872340425,100
Kaʻilianu,28,23,51,0.5490196078431373,100
Kaiʻa,46,31,77,0.5974025974025974,100
Kaina,27,20,47,0.574468085106383,100
Kaipo,23,19,42,0.5476190476190477,100
Kaiwi,56,41,97,0.5773195876288659,100
Kalā/Kala,32,17,49,0.6530612244897959,100
Kalama,68,60,128,0.53125,100
Kalawaiʻa,61,38,99,0.6161616161616161,100
Kalehua,23,19,42,0.5476190476190477,100
Kalei,24,16,40,0.6,100
Kaleo,23,20,43,0.5348837209302325,100
Kalili,42,34,76,0.5526315789473685,100
Kalua,197,130,327,0.6024464831804281,100
